sq_orig	sq_mod
Të rekumenduom nd uratë gjith atyne , qi t a marrënë me e xgjedhunë .	Të rekumenduar në uratë gjithë atyre , që ta marrin për ta zgjedhur.
Vëllazënitë e dashunë e të feeshimitë bijtë e Krishtit !	Vëllezërit e dashur e të feshëm bijtë e Krishtit !
Disa herë tue kujtuom të vdierrëtë e gjith aqë të madh dam të shintesë fee , qi u baa ende po bahetë për gjithë ditë ndë gjuhu-tanë maa keq me dhuunë se ndoonjii tjetër dore gjindje përmbii dheet , e tue paam ashtu ende , se këta diesitë e letërorëtë e hollë , qi u vien n dore ashtu gjaakafshë me ndimuom , e lanë shkret e gjaa maa s po ndimonjënë , – maa s keshë tietër qish me baam , veçëse hina mbarë e mprapë , sido munda , shkrova mbë gjuhu-tanë maa parë do kapituj të Ditësë Gjyyqit , qi i gjeta shkruom atit shumë ncë ndeershim e ncë devotshim frat Paalit prej Hasi .	Disa herë duke kujtuar të vdjerrët e gjith aq të madh dëm të së shenjtës fe , që u bë edhe po bëhet për gjithë ditë në gjuhën tonë më keq me dhunë se ndonji tjetër dor gjindje përmbi dhe , e duke parë ashtu edhe, se këta dijetarët e letrarët e hollë , që u vjen ndore ashtu gjëkafshë për të ndimuar , e lanë shkretë e gjë më s'po ndihmojnë , – më s'kisha tietër ç'të bëja , veçse hyra  mbarë e prapë , sido munda , shkrova në gjuhën tonë më parë do kapituj të Ditës së Gjyyqit , që i gjeta të shkruara atit shumë të ndershëm e të devotshëm frat Palit prej Hasi .
Të ciitë ende me do të tjera të nçtuome disa herë tue i shkruom , kuur tue paam se ishnë për të madhe ndimë e fruj-të shpiirtit t atii populli e aqë maa tepërë të disa priftëne , qi dëshërojnë me i pasunë , hina për gjithë ditë kaa pak tue nçtuom .	Të cilët ende me do të tjerë të shtuar disa herë duke i shkruar , kur duke parë se ishin për të madhe ndihmë e fruj-të të shpirtit të atij populli e aq më tepër të disa priftërve , që dëshirojnë me i pasur, hyra për gjithë ditë nga pak duke shtuar.
Shkrova ende saa të tjera kafshë , saa mujta ncë tiera gjuhush tue i nkthyem mbë gjuhu-tanë .	Shkrova edhe sa të tjera gjëra, sa munda prej gjuhësh të tjera duke i kthyer në gjuhën tonë .
E ndeevonë , mbasi andej u daashë , erdhshë mbë Romë , ke ashtë gurra e gjallë e gjithë herëvet .	E më vonë , mbasi andej u ndava , erdha që Romë , që është gurra e gjallë e gjithë herëve .
Tue paam , se gjuha jonë asndoonjë letërë e të mpsuom s e kaa , me të ciit të mundeej ndërta mee u ndimuom feeja e Krishtit , zuna fiill mund aqë saa munda , nktheva këtë shinte Doktrinë gjuhet së lëtine mbë gjuhu-t arbëneshe – si për ndimët të atii populli ashtu ende me nxierrë pakëzë gjumënë e disave , qi pakmos gjithë të riitë e jetënë e vet e shkuonë ndë të mbrazëtë paa mos lanë ndoonjë të përmendunë të mirë mbas vetëhe .	Duke parë se gjuha jonë as ndonjë letër e të mësuar s'ka , me të cilat të mundej ndër ta të ndihmohej feja e Krishtit , zura fill me aq sa munda , ktheva këtë të shenjtë Doktrinë prej gjuhës latine në gjuhën arbëreshe – si për ndimët të atij populli ashtu edhe për të nxjerrë pakëz gjumin e disave , që pakmos gjithë të rinjtë jetën e vet e shkojnë në të zbrazët duke mos lënë ndonjë të përmendur të mirë mbas vetes .
Të ciinë ndoonëse me pak fëdigë mbasi e mbarova , m u baa kori , qi disa e dërgova , disa mbet këtu .	Të cilën ndonëse me pak fëdigë mbasi e mbarova , m'u bë kori , që disa e dërgova , disa mbeti këtu .
E ndevonë , kuur maa për ngee tue e vuum roe , për pak fjalë , qi më duknë , se s jesënë mirë , qish ndodhi , këha ndë një ças fienë e parë e hoqa , e vent-atë saaj shtampova tjetërënë maa mirë .	E më vonë , kur më për nge duke vënë re , për pak fjalë , që m'u dukën se s'jesën mirë , qysh ndodhi , këtu në një çast fletën e parë e hoqa , e në vend të saj shtypa tjetrën më mirë .
Praashtu mos u vinjë gjaa keq pr ata , përse mb atë herë disa tue qenë puna për të ngutunë , disa u tue qenë vetëmë e jo aqë vesht ndjerë nd anët , disa shtampatorëtë tue mos diijtunë gjuhunë , – mos mërekullonii aqë ndjerë nd anët ncë mangut , qi të gjeeni , po se ende kaqë ku kam mundunë me e mbaruom .	Kështu mos u vijë gjë keq për to, sepse atëherë disa duke qenë puna për të ngutur , disa unë duke qenë vetëm e jo aq vesht ndjerë në anët , disa shtypësit duke mos ditur gjuhën , – mos u mrekulloni aq ndjerë nd anët ncë mangut , që të gjeni , po se ende kaq ku kam ta mbaroj .
E tashti , tue mos dashunë maa tej me ngjatunë , jo tjetërë veçëse , – mbasi u jam porësitunë ndr ato shinte uratë , qi jemi detuor njani për tjetërit , – u rekumendonj e u porësit ashtu ende gjith atë popullë e kërshtënim , qi kini ndaj vetëhenë , e aqë maa tepërë ata , qi kini marrë përpara vetii e nzotunë posikuur bariu grigjnë me i ruojtunë ndër gjithë saa janë kafshë të shpiirtit , – ashtu qi ndeevonë u pr uratë-tuoj e për të madhet mëshërier të Tinëzot , e ju për të nzyyrmit e fëdigët e kujdes-taaj , e ata për të prunjëtit e obedienciet e ndimët të korpit , qi t u banjënë gjithë ncë bashku , a t a kishnjimë atë fat me u paam njani me tjetërit ndë parriisit e regjënii-të qiellet , ke ndaj engjiit e ndaj shintënit të lëvdojmë shintinë emënitë e tii për gjithë jetë-të jetësë .	E tashti , duke mos dashur më tej të zgjatem , jo tjetër veçse , – mbasi unë jam porositur ndër atë të shenjtë uratë , që jemi borxhlinj ndaj njëri-tjetrit , – u rekumendoj e u porosit ashtu edhe gjith atë popull e krishterim , që keni ndaj vetes , e aq më tepër ata , që keni marrë përpara vetes e nzotunë posi bariu grigjën për të ruajtur ndër gjithë sa janë gjëra të shpirtit , – ashtu që më vonë u për uratën tuaj e për të madhe mëshërier të Tinëzot , e ju për të nzyyrmit e lodhjen e kujdesin tuaj , e ata për të prunjëtit e obedienciet e ndimët të trupit, që të bëhen të gjithë së bashku , a ta kishim atë fat për t'u parë njëri me tjetrin në parajsë e mbretëri të qiellit , ke ndaj engjëllit e ndaj shenjtit të lëvdojmë shenjtin emrin e tij për gjithë jetë të jetës .
Amen , ashtu qoftë .	Amin , ashtu qoftë .
Prej Rome të 7. ditë ndë kallënduor ndë vietë-të Krishtit 1618 .	Prej Rome të 7-n ditë në kallnor të vitit 1618 të Krishtit .
Gaatii ndë gjithë shërbëtyrë , i prunjëti vëllai i zotëniisë saaj dom Pietrë Budi prej Gurit së Bardhë , vikari gjeneraal i Shurbiisë .	Gati në gjithë shërbim , i prunjëti vëllai i zotnisë suaj dom Pjetër Budi prej Gurit të Bardhë , vikari i përgjithshëm i Serbisë .
Doktrina tashti mbë këtë arrësye vuum e ndërequnë për ndimët e të mpsuomi-të t kërshtenëvet .	Doktrina tashti për këtë arsye vënë e ndrequr për ndihmën e mësimin e të krishterëve .
ti njaj mbramje , tue folë me gjakont të vet njanënë fjalë e tietërënë e aqë maa tepërë themelit së shintesë fee e jetet s amëshuome , për ndimët e të mpsuomit të tjerëvet pyeti një ncish maa të diijtëshiminë tue i thanë , se : A jee ti i kërshtenë ? – përse këjo ashtë themeli e kryetë e gjithë kafshëvet për të shelbuom .	Thotë , se prifti një mbrëmje , duke folur me dhjakun e vet njërën fjalë e tjetrën e aq më tepër themelit të së shenjtës fe e jetës së amshuar , për ndimën e mësimin e të tjerëve pyeti një syresh më të dijshmin duke i thanë , se : A je ti i krishterë ? – përse kjo është themeli e kryet e gjithë gjërave për të shëlbuar .
E dhjaku, që e dinte mirë arsyen , se si duhet të përgjigjej, bukur gojëplot mbet e i tha , se : Jam për hir të Krishtit mëshirëplotë , zotit tonë .	E gjakoni , qi mirë e diij arrësyenë , se si duhetë me j rresponduom , bukur gojëplot mbet e j tha , se : Jam për hiirt të Krishtit mëshëriershim , zotit tynë .
E prifti : Qish kafshë do me thanë i kërshtenë ?	E prifti : Çfarë do të thotë i krishterë ?
E dhjaku: I krishterë tjetër s'do të thotë veçse një , që me gjithë zemër e shpresë beson në fenë e shenjtë të Krishtit mëshirëplotë, zotit tonë .	E gjakoni : I kërshtenë tjetër s do me thanë veçëse një , qi me gjithë zemërë e shpëresë mbeson mbë shintet fee të Krishtit mëshëriershim , zotit tynë .
E prifti : A mun a diish ti , se ndë se mbahetë feeja e Krishtit ?	E prifti : A mund ta diish ti , se në se mbahet feja e Krishtit ?
E dhjaku : Mbahetë ndër dyy të tinëzshime , qi janë mbuluom ndëne të baamit të shintesë kryyq , së nciashit njana kallëzon , se Zotyynë i mëshëriershimi , tue qenë ndë tre vetë , ashtë nja i vetëmi .	E gjakoni : Mbahet ndër dy të fshehta , që janë mbuluar nën të bërit të kryqit të shenjtë , nga të cilat njëra kallëzon se Zoti ynë i mëshirshëm , duke qenë në tre veta , është një i vetëm .
E tjetëra ashtë t ardhunitë mbë këtë jetë e të leemitë e muundinë e mortnë e Krishtit mëshëriershim , zotit tynë .	E tjetra është të ardhurit në këtë jetë e të lindurit e mundin e mortin e Krishtit të mëshirshëm , zotit tonë .
E prifti : Pa më thuo , se : Mbë qish arrësye ndëgjonetë këja fjalë ‘ ndë tre vetë një i vetëmë Zotyynë ’ ?	E prifti : Pa më thuaj , se : Në ç'arsye kuptohet kjo fjalë ‘ në tre vetë një i vetëm Zoti ynë ’ ?
E gjakoni : Përse ndë Tenëzotnë ashtë një e vetëme zotënii , e njaj natyre i paadaam , maa ashtë ndë tre vetë , qi quhenë Ati e Biri e Shpiirti Shint .	E dhjaku: Sepse në Tënëzonë është një e vetme zotni , e një natyre i pandarë , po është në tre veta , që quhen Ati e Biri e Shpirti i Shenjtë .
E prifti : Doe të m a thoshnje këtë fjalë ende maa nçelë ? – ndë mos , ndoonee me qishdo shemëllëtyrë të kësaaj jete , veçëse qi të mundnjë ende maa mirë me e ndëgjuom , se si e mbë qish arrësye munë ndëgjonetë këjo ‘ ndë tre vetë një i vetëmë Zotyynë ’ .	E prifti : Do të ma thoshje këtë fjalë edhe më çelë ? – në mos , ndoonee me çdo shembëlltyrë të kësaj jete , veçse që të mundë edhe më mirë për ta kuptuar , se si e për ç'arsye mund të kuptohet kjo ‘ në tre veta një i vetëm Zoti ynë ’ .
E gjakoni për shemëllëtyrë mbet e j tha , se : Pakmos mbë këtë arrësye .	E dhjaku për shembëllëtyrë mbeti e i tha , se : Pakmos për këtë arsye .
Një herë nji i kërshtenë e një xhudhii tue kundrështuom njani me tjetërit , xhudhiu , posi i paafee qi ish , mbet e j tha , se : Si munë jeetë Ati e Biri e Shpiirti Shint një i vetëmë Zotyynë ?	Një herë një i krishterë e një hebre duke kundrështuar njëri-tjetrin , hebreu, si i pafe që ish , mbet e i tha , se : Si mund të jetë Ati e Biri e Shpirti i Shenjtë një i vetëm Zoti ynë ?
E aj i kërshteni , ndoonëse s ish aqi i diijtëshim , – thoshnje , se ndë një ças Shpiirti Shint j a shtiu ndë mend me j thanë , se : Si munë jeetë ujëtë e vdora e akulli të tre nja ?	E ai i krishteri , ndonëse s ish aq i dijshëm – të thuash, se në një çast Shpirti i Shenjtë ia shtiu ndër mend t'i thotë , se : Si mund të jetë ujët e bora e akulli të tre një ?
Për të ciit fjalë me arrësye xhudhiu mbet sikuur ngatërruom e maa s qe i zoti as me j rresponduom .	Për të cilat fjalë me arsye hebreu mbeti si i ngatërruar e më s'qe i zoti as t'i përgjigjej .
Ashtu ende u tyy tashti s jam i zoti maa t afërë tjetër shemëllëtyrë me të dhanë jashtë këncoje – ndo anco cë diellit , qi i dha aj mjeshtri mb atë herë atii shërbëtorit vet , qi e pyeti , tue i thanë , se : Posikundrëse dielli tue qenë nja i vetëmi kaa ndë vetëhe dritënë e të nxeetitë , gjithë njaj natyre të paadaam , – ashtu ende Ati i qiellet tue qenë nja i vetëmi kaa ende Biirrë e Shpiirtinë Shint , të tre një i vetëmë Zotyynë e njaj natyre të paadaam .	Ashtu edhe unë ty tashti s jam i zoti më t afërë tjetër shembëlltyrë të të jap jashtë këncoje – ndo aso së diellit , që i dha ai mjeshtri atë herë atij shërbëtorit të vet , që e pyeti duke i thënë se : Posikundërse dielli duke qenë një i vetëm ka në vete dritën e të nxehtit , gjithë një natyre të pandaarë , – ashtu edhe Ati i qiellit duke qenë një i vetëm ka edhe birin e Shpirtin e Shenjtë , të tre një i vetëm Zoti ynë e një natyre të pandarë .
Këjo pak e shumë mun epetë për shemëllëtyre e jo maa tjetër .	Kjo pak a shumë mund të jepet si shembull e jo më tjetër .
Përse ku munë gjindetë krautyrë , qi të mundeej me u shëmënjyem me kriijuosit ?	Përse ku mund të  gjendet krijesë , që të të ngjajë me krijuesit ?
Oo kaha t ish ardhunë j atilli dies e letëruor gjith aqi i hollë , qi të mundënte njëmijë pjesësh një me e kallëzuom gjith aqii ncë randi e ncë madhejet zotëniet së tii ?	O nga të ish ardhur i atillë i ditur e letrar gjithë aq i hollë , që të mundte një mijë pjesësh një për të kallëzuar gjithë aq së rëndi e së madheje zotnisë së tij ?
Oo ku të munë gjindiishnë syytë e korpit gjith aqë të kthjellëtë e të dëlirë , qi të mundnjinë t atiinë perëndii me e paam ? – të ciinë thotë , se aqii drite ncë madhe saa aty e eengjiitë dëshëronjënë dërejt ndë faqet me e shukuom .	Oo ku të mund të gjendeshin sytë e trupit gjithaq të kthjellët e të dëlirë , që të mundë të atin për ta parë ? – të cilin thotë , se aq drite së madhe sa aty e engjëjt dëshirojnë drejt në faqe ta shikojë .
Po kush kaa pak oo shumë mend e shqise e të ndëgjuom ndë vetëhe , – mëjaft ashtë për nee e për të shelbuomit tanë , t a veemë roe e t a njofmë me syy-të mendet e të shpiirtit , tue e dashunë me gjithë zemërë e përmbii gjithë kafshët e tue shërbyem shintinë urdhënë e ligjnë e tii , jo ndryshej oo mbë qishdo tjetër arrësye po ashtu sikundrëse shinteja ama kishë katolike me drit-të Shpiirtit Shint e kaa urdhënuom e ndërequnë .	Po kush ka pak o shumë mend e shqisa e të kuptuar në vete , – mjaft është për ne e për të shëlbarit tanë , ta vëmë re e ta njohim me sy të mendjes e të shpiirtit , duke e dashur me gjithë zemër e përmbi gjithë gjërat e duke shërbyer të shenjtin urdhër e ligjin e tij , jo ndryshe o më qyshdo tjetër arsye po ashtu sikundërse shenjtja ama kishë katolike me dritë të Shpirtit të shenjtë e ka urdhënuar e ndrequr .
Përse na ndë dashimë posi shumë të tjerë me hipunë me këto të pyetuna e të çqyrëtime atje , ke s jemi të zotë me mbeerriim , aqii ncë nelt qi rrëzohemi e biemë , saa askuurraaj maa s jemi të zotë me u ngriijtunë .	Përse ne në daçim posi shumë të tjerë të hipim me këto të pyetura e shqyrtime atje , ku s'jemi të zotë të mbërrijmë , aq së lartiqi rrëzohemi e biem , sa askurrë më s jemi të zotë të ngriihemi .
Kush kaa veshëtë , kaqë mëjaft ashtë .	Kush ka veshë , kaq mjaft është .
Përse do kafshë , qi më pyet zotënia jote , s përkasënë kuujnaaj tjetëri me j diijtunë veçëse shintënet , qi janë mbë qiellt , e doktorëvet shintesë kishë , qi Shpiirti Shint kaa folë ende po flet për gojët të tyne – e jo muo e tyy , qi s jemi të zotë e të denjë as rrypnë e këpucësë tyne me u lidhunë e me u xgjidhunë .	Përse do gjëra, që më pyet zotnia jote , s'i përkasin kujt tjetër t'i dijë veçse shenjtëve, që janë në qiell , e doktorëve të kishës së shenjtë , që Shpirti i Shenjtë ka folë edhe po flet për gojë të tyre – e jo mua e ty , që s'jemi të zotë e të denjë as rripin e këpucës së tyne ta lidhin e ta zgjidhin .
E prifti mbet e j tha , se : Ajo ashtu ashtë mirëfilli e për të vërtetë .	E prifti mbeti e i tha , se : Ajo ashtu është mirëfilli e për të vërtetë .
Maa ende na paa mos folë e çqyrëtunjë gjaakafshë mbë këtë arrësye s jemi të zotë me e njofunë zemërënë e shqisenë e njani tjetërit .	Më edhe na pa mos fol e shqyrtuar gjëkafshë në këtë arsye s'jemi të zotë ta njohim zemrën e shqisën e njëri-tjetërit .
Praashtu pa më thuo , se : Mp sa oo për qish arrësye janë tre vetë ndë Tenëzotnë e ja tepërë oo mangu ?	Prandaj pa më thuaj , se : Mp sa o për ç'arsye janë tre vetë në Tenëzonë e jo tepër o mangët ?
E gjakoni : Përse Ati kaa qenë e ashtë i paa të zanë fiill e j paa meenguom kuurraaj për gjithë jetët-të jetësë e s vien tjetër ane , përse aj ashtë të zanëtë fiill , qi jet përmbii gjithë kafshët e ndër gjithë kafshët , e themeli i gjithë kafshëvet .	E dhjaku: Përse Ati ka qenë e është pazanë fil e i pamunguar kurrë për gjithë jetë të jetëve e s'vjen tjetër ane , përse ai është të zënët fill , që mbetet përmbi gjithë gjërat e ndër gjithë gjërat, e themeli i gjithë gjërave.
Maa Biri vjen prej Atit posikuur drita prej diellit ;	Pra Biri vjen prej Atit posikur drita prej diellit ;
e Shpiirti Shint vjen Atit e Birit posikuur të nxeetitë n djellit e dritet së tii .	e Shpirti i Shenjtë vjen prej Atit e Birit posikur të nxehtët prej diellit e dritës së tij .
E prifti përsërii : Pa me thuo , se : Mp sa e për qish arrësye këta të tre vetë janë një i vetëmë Zotyynë ?	E prifti përsëri : Pa më thuaj , se : Mp sa e për ç'arsye këta të tre vetë janë një i vetëm Zotynë ?
E gjakoni : Posikundrëse të thashë përsipëri , se janë të tre njaj natyre të paadaam – si ujëtë e vdora e akulli ndo dielli , të nxeetitë e drita e tii , – e kanë ncë bashku një të qenë e të mbetunë e puçtet e zotënii e një të dashunë e të mirë aqë të madh e të lëvduom , saa askuurraaj kandi s i dihetë , ashtu as gjuhet së n’jeriut s munë kallëzonetë .	E dhjaku: Po sikundërse të thashë më sipër , se janë të tre të një natyre të pandarë – si ujët e bora e akulli  ndo dielli , të nxehtët e drita e tij , –  e kanë së bashku një të qenë e të mbetur  e pushtet e zotni e një të dashur e të mirë aqë të madhe e të lëvduar , sa askurrkëndi s'i dihet , ashtu as me gjuhë të njeriut s'mund të kallëzohet .
E prifti : Pa më thuo , se : Qish kafshë shëmënjen e do me thanë këta të sdripunë të Krishtit e të marrëtë korp e të përziemitë e tii me këtë natyrë tanë e gjithë aqë muund e mortnë e tii përmbii dheet ?	E prifti : Pa më thuaj , se : Ç'gjë shembëllen e do të thotë ky të zbritur i Krishtit e të marrëtë trup e të përzierit e tij me këtë natyrë tonën e gjithaq mund e mortin e tij përmbi dhe ?
E gjakoni : Këjo , kush kaa pak oo shumë mend e shqise ndë vetëhe , tjetër s do me thanë , veçëse na kallëzon nee , se nji i vetëmi i Biri i Tinëzot për ndimët e të shelbuomi-tanë sdripi n qiellshit e u baa n’jeerii , e mbasi triidhjetë e trii vjet eci përmbii dheet , tue na mpsuom ligjnë e feenë e shintinë ungjiill e tue baam aqë shinje e mërekullii , saa askuurraaj s ishnë gjegjunë as paam .	E dhjaku: Kjo , kush ka pak a shumë mend e shqisë në vete , tjetër s'do të thotë, veçse na kallëzon neve , se një i vetëm i Biri i Tinëzot për ndihmë e shëlbimin tonë sbritii nga qielli e u bë n’jeerii , e mbasi tridhjetë e tre vjet eci përmbi dhe , duke na mësuar ligjin e fenë e ungjillin e shenjtë e duke bërë aq shinje e mrekulli , sa askurrë s'ishin dëgjuar e parë .
Ndeevonë gjindja e helmuome e e paanjofunë për të mirat të baame e zuunë e e lidhnë e e munduonë e j dhanë një mort aqë t idhunë e të mëryeshime mbë druu-të kryqsë , saa përnjëherë tue lëshuom shpiirtinë dridhti e u tristuo gjithë rrethi i shekullit , e muri i tempiesë , qi nd atë mot ish kisha e Tinëzot , plasi përmjedis njanet anë e mp tjetërët , e dielli mb atë arrësye u nxii e vduor atë të lëvduomenë dritënë e vet , saa dita ndë mjesëditët u err e u baa posikuur natënë , e saa të vdekunë e korpëna shintënish u ngjaallë e u kallëzuonë shumëve , tue dëshmuom e tue thanë , se : Aj qe mirëfilli e për të vërtetë i Biri i Tinëzot .	Më vonë gjindja e helmuar e e panjohur për të mirat e bëra e zunë e e lidhën e e munduan e i dhanë një mort aq të  hidhur e të habitshëm në dru të kryqit , sa përnjëherë duke lëshuar shpirtin dridhti e u trishtua gjithë rrethi i shekullit , e muri i tempullit , që në atë mot ish kisha e Tinëzot , plasi përmidis njërës anë e më tjetrën , e dielli për atë arsye u nxi e vdori atë të lëvduar dritën e vet , sa dita në mesditë u err e u bë posikur natë , e sa të vdekur e trupa shenjtësh u ngjallën e u kallëzuan shumëve , duke dëshmuar e duke thënë , se : Ai që mirëfilli e për të vërtetë i Biri i Tinëzot .
E këtë kafshë s e bani për tjetër veçëse për nee fajëtorët , përse qi mb atë arrësye me na çpërbleem me të paaçmuomit gjak të vet e me na lëshuom anci sënxhiri ncë helmuom , ndë të ciit qemë raam , e detyre nc atii mpkati , qi baanë printë e parë ndë parriisit , për të ciit me të madh helm e t idunë qenë vduom e qitunë jashtë hirit së Tinëzot e lavdit së parriisit , – sikundrëse ata ashtu ende gjithë të ndjekunitë e gjëniisë tyne ndeevonë maa se për pesë mijë vjet , ndjerë mos erdh Krishti mbë shekullit .	E këtë gjë s'e bëri për tjetër veçse për ne fajtorët , përse që për atë arsye të na shpërblejë me të paçmuarit gjak të vet e për të na lëshuar anci sënxhiri të helmuar , në të cilin kishim rënë , e detyre së atij mëkati , qe bënë prindët e parë në parajsë , për të cilët me të madh helm e hidhërim qenë humbur e qitur jashtë hirit të Tinëzot e lavdit të parajsës , – sikundërse ata ashtu edhe gjithë të ndjekurit e gjinisë së tyre më pas më se për pesë mijë vjet , deri mos erdhi Krishti në botë.
Përse thotë , se aj mpkati i tyne mb atë herë aqi i randë e j madh qi duku përpara Tinëzot , saa askuurraaj mbë ndoonjë tjetër arrësye mëngjii s mujti me gjetunë ,  ndjerë mos sdripi j atilli mjeek prej qiellshit t atiinë plagë e të keqe me e shëndoshunë e me e çpërbleem shekullinë .	Përse thotë , se ai mëkati i tyre atëherë aqi i rëndë e i madh që u duk përpara Tinëzot , sa askurrë më ndonjë tjetër arsye mëngji s'mundi të gjente , derisa të mos zbresë i atillë mjek prej qiellit të atillë plagë e të keqe për ta shëndoshur e për ta shpërblyer botën.
me gjithë aqë mundime e gjakt të vet të paaçmuomit .	me gjithaq mundime e gjak të vet të të paçmuarit .
E prifti mbet e j tha , se : Pa më thuo , se si oo mbë qish arrësye janë mbuluom këto të dyy të tinëzshime ndënë të baamit të shintesë kryq ?	E prifti mbet e i tha , se : Pa më thuaj ,  se si o për ç'arsye janë mbuluar këto të dy të tinëzshime nën të bërit të kryqit të shenjtë ?
E gjakoni : Përse të shinjifikuomitë e shintesë kryq banetë mbë këte arrësye , tue vuum maa parë m ballë dorënë e djathë e tue thanë , se : pr emënit të Atit – ani mbë zemërë tue thanë : e Birit – e ndeevonë përnjëherë tue prekunë buzënë e krahit shtëmangtë e mbë të djathët e tue thanë : e Shpiirtit .  Amen .	E dhjaku: Përse të shinjifikuomitë e kryqit të shenjtë bëhet për këtë arsye , duke vënë më parë në ballë dorën e djathtë e duke thënë , se : për emër të Atit – pastaj mbi zemër duke thanë : e Birit – e pastaj përnjëherë duke prekur buzën e krahut  të majtë e më të djathtë e duke thënë : e Shpirtit . Amin .
E prifti : Pa më thuo , se : Me qish arrësye këjo fjalë e shëmënjen të Shëndriitatnë ?	E prifti : Pa më thuaj , se : Për ç'arsye kjo fjalë e shëmënjen të Shëndriitatnë ?
E gjakoni : Përse këjo fjala e parë , qi thotë : pr emënit të Atit – këjo shëmënjen një të vetëminë zot bashkë me këto të dyy të tjerat , qi thotë : e Birit e Shpiirtit Shint – shëmënjenjënë të Shëndriitatnë .	E dhjaku: Përse kjo fjala e parë , që thotë : për emër të Atit – kjo shëmënjen një të vetmin zot bashkë me këto të dy të tjerat , që thotë : e Birit e Shpirtit të Shenjtë – shëmënjenjënë të Shëndriitatnë .
E prifti : Pa më thuo gjaakafshë ende kënci kshillit së dyyjtë !	E prifti : Pa më thuaj gjëkafshë edhe kësi këshillit së dytë !
Maa parë se si e mbë qish arrësye duhenë me qenë shërbyem këto shinte sakramente .	Më parë se si e më qysh arsye duhen shërbyer këto të shenjta sakramente .
Posikundrëse qysh moti këto kafshë shinteja ama kishë katolike me saa të denja e të dërejta arrësenje i kaa urdhënuom e ndërequnë me urdhëni-të shintet kanone e të saa papëve e atëshintëne për të shërbyemi-të shintevet sakramente e të gjithë saa janë çerimoniavet tyne , tashti këtu po i shkruonjëmë paa shumë të tjera të përziena , ashtu qi këndyy tutje ende maa tepërë se ndierë mp sod me saa kujdes e të dëlirë zemërë të jeenë shërbyem e ruojtunë , posikundrëse këtu për fundit gjithë kafsha kaa me qenë tfiilluom e ndërequnë .	Posikundërse qysh moti këto gjëra e shenjta amë kisha katolike me sa të denja e të drejta arsye i ka urdhëruar e ndrequr me urdhër  të të shenjtave ligje e të sa papëve e Atit të Shënjtë për të shërbyerit e te shenjteve sakramente e të gjithë sa janë cerimonive të tyre , tashti këtu po i shkruajmë pa shumë të tjera të përziera , ashtu që këndej e tutje edhe më tepër se deri më sot me sa kujdes e të dëlir zemër të jenë shërbyer e ruajtur , posikundërse këtu për fundit gjithë gjëja do të jetë ftilluar e ndrequr .
E maa tepërë përmbii gjithë kafshët mirë të venë roe gjithëkush plot me arrësye me shërbyem e me mbaajtunë ato kafshë , qi me saa të denja e të dërejta arrësenje i kaa ndërequnë e urdhënuom shinti Concilio Tridentino , veçë n gjithë ncë tjerashit ndë sesione-të 7. tue thanë , se : Këndyy tutje gjithëkush të kapërcenjë oo të shkonjë ndoonjë kafshë shërbëtyret së shintevet sakramente oo me qishdo fjalë të shtierë kundrë , tue thanë , se s janë mirë e me arrësye ndërequnë e urdhënuom gjith ato kafshë , qi ndierë m tashti bukur i kaa njofunë e provuom e përzanë shinteja ama kishë katolike – oo me qishdo ashtu tietër arrësye tue mos baam stimë prej ncosh , t i mbee sikuur pr asgjaa e për kafshë të mbrazëta – oo të zanë fiill me baam qishdo të tjera çerimonie e zakone të rea , tue i ndërruom njaj arrëseu mbë një tietërë , Anatema sit – mallëkuom qoftë !	E më tepër përmbi gjithë gjërat mirë të vërë re gjithkush plot me arsye për të shërbyer e për të mbajtur ato gjëra, që me sa të denja e të drejta arsye i ka ndrequr e urdhëruar i shenjti Koncili Trentin , veç në gjithë së tjerash në sesion të 7. duke thënë , se : Këndej e tutje gjithkush të kapërcejë o të shkojë ndonjë send shërbimet e të shentave sakramente o me qyshdo fjalë të shtjerë kundër , duke thënë , se s'janë mirë e me arsye ndrequr e urdhëruar gjithë ato gjëra, që deri më tashti bukur i ka njohur e provuar e ruajutur e shenjta ama kishë katolike – o me qyshdo ashtu tjetër arsye duke mos bërë stimë prej syresh, t'i mbajë sikur për asgjë e për gjëra të zbrazëta – o të zërë fill për të bërë qyshdo të tjera ceremoni e zakone të reja , duke i ndërruar një arsye më një tjetër , Anatema sit – mallkuar qoftë !
Përse mb atë herë , kuur gjithëkush mirë tue e njofunë e tue e diijtune , se nde kishë-të Tinëzot s ashtë maa shinte as ma e viejtëshime e e lëvduome kafshë se shintetë sakramente për të shelbuomi-të shekullit , jo ndoonjii tjetër ane zanë fiill oo urdhënuom e e ardhunë maa parë veçëse Krishtit së mëshëriershim , zotit synë , – praashtu prifti oo qishdo tjetërë ndë shintit urdhënë , qi të doë mirë e me arrësye , si do ligja , këto shinte sakramente me j shërbyem , bukur i duhetë t i nçelnjë syytë e mendet e të shpiirtit maa tepërë se ata të korpit , qi pak kafshë munë shohonë , mirë tue vuum roe e tue kujtuom vetë ndë vetëhe , se aj aty mb atë arrësye po del e kallëzonetë përpara faqesë Tinëzot e përzihetë e përket me duor-të vet saa të randa kafshë gjithë shinte e të shekruome , qi s përkasënë tietërkuujnaaj veçesë shintënet eengjiivet Tinëzot .	Përse më atë herë , kur gjithkush mirë duke e njohur e duke e ditur , se në kishë të Tinëzot s'është më e shenjtë as më e vlefshme e e lëvduar gjë se të shenjtat sakramente për të shëlbuarit të dheut , jo ndonjë tjetër anë zënë fill o urdhëruar e e ardhur më parë veçse Krishtit të mëshirshëm , zotit tonë , – pra ashtu prifti o kushdo tjetër në  të shenjtin urdhër , që të dojë mirë e me arsye , si do ligja , këto të shenjta sakramente t'i shërbejë , bukur i duhet t'i çelë sytë e mendjes e të shpirtit më tepër se ata të trupit, që pak gjë mund të shohin , mirë duke vënë re e duke kujtuar vetë në vete , se ai aty më atë arsye po del e kallëzohet përpara faqes së Tinëzot e përzihet e përket me duart e veta sa të rënda gjëra gjithë të shenjtat e të shkruara , që s'i përkasin tetërkujt veçse shenjtëve e engjëjve të Tinëzot .
Prashtu t atiitë duhetë të jeenë gjithëherë ndë frikët e tmeer-të Tinëzot , me të madh kujdes e të nzyyrunë tue u gjetunë gaatii ndë gjithë mot e koho e horë të ditësë e të natësë , kuurdo e kedo të jeenë thirrë e grishunë , këto shinte sakramente me j shërbyem paa ndoonje të vonuom , të ciecienë ndë kohot e ndë mo-të vet .	Pra ashtu të atillë duhet të jenë gjithherë në frikë e tmerr të Tinëzot , me të madh kujdes e të nzyyrunë duke u gjetur gati në gjithë mot e kohë e horë të ditës e të natës , kurdo e kudo të jenë thirrur e grishur , këto të shenjta sakramente për t'i shërbyer pa ndonjë të vonuar , të ciecienë në kohë e në mot të vet .
E jo veçëse gaatii e për të çpejtë këtyne kafshëve gjithëherë duhetë me u gjetunë , po ashtu ende me të madh të mpastrë e jetë të dëlirë posikundrëse të korpit ashtu ende maa tepërë të shpiirtit .	E jo veçse gati e për të shpejtë këtyre gjërave gjithherë duhet të gjenden , po ashtu edhe me të madh të pastër e jetë të dëlirë posikundërse të trupit ashtu edhe më tepër të shpirtit .
Përse thotë , se , ndoonëse shintetë sakramente s munë pëgahenë as munë palavohenë , ashtu as munë vdierrënë forcënë e vërtytnë e vet ncë paadenjit e ncë paadëlirit së priftënet e t atyne , qi i shërbenjënë , – asgjaamangu veçëse vaaj e vaaj ncish , qi për të paadenjët e të paadëlirë-të vet kanë me u gjetunë të denjëtë e mundimevet ferrit e të zjarmit amëshuom për gjithë jetë-të jetësë !	Përse thotë , se , ndonëse të shenjtat sakramente s'mund të pëgëhen as mund të palavohen , ashtu as mund të vdirren forcën e virtytin e vet së padenjit e së padëlirit së priftërit e atyre , që i shërbejnë , – asgjëmangu veçse vaj e vaj sish , që për të padenjët e të padëlirë të vet kanë për t'u gjetur të denjët e mundimeve të ferrit e të zjarmit të amshuar për gjithë jetë të jetës !
Praashtu thotë , se prifti oo kushdo tjetër mb atë arrësye , qi të jeetë përziem ndë këtë shinte shërbëtyrë , gjithë herë e ndë gjithë koho , qi t a ndienjë vetëvetëhenë e shpiirtinë e vet plaguom e farmakuom me shigjetët e farmëku-të ndoonjii mkati murtaar , aspak paa mos u rrëfyem e xgjidhunë mkatit maa parë , mos afronetë e mos përzihetë ndë ndoonjë kënco shinte sakramentesh .	Pra ashtu thotë , se prifti o kushdo tjetër më atë arsye , që të jetë përzier në këtë të shenjtë shërbim , gjithherë e në gjithë kohët , që ta ndiejë vetveten e shpirtin e vet të plaguar e të farmakuar me shigjetat e farmakut të ndonjë mëkati mortar , aspak pa u rrëfyer e zgjidhur mëkatit më parë , të mos afrohet e të mos përzihet në ndonjë këso të shenjta sakramente .
Maa ke t i goditeej kafsha ashtu , qi aqë për të çpejtë të mos mundeej me u rrëfyem , e aj ndoonee vetë ndë vetëhe përpara faqesë Tinëzot të jeetë me gjithë zemërë nkthyem e peenduom e ndeevonë , saa maa çpejt qi të mundnjë , të rrëfyhetë e të xgjidhetë mkatit .	Më ku t'i goditej gjëja ashtu , që aq për të shpejtë të mos mundej të rrëfehej , e ai ndoonee vetë në vete përpara faqes së Tinëzot të jetë me gjithë zemër i kthyer e i penduar e pastaj, sa më spejt që të mundë , të rrëfehet e të zgjidhet prej mëkatit .
E ashtu ende thotë , se gjithëherë e kuurdota , ndë qishdo koho e horë të ditësë e të natësë të jeetë grishunë e thirrë mbë ndoonjë kënco shinte sakramentesh , aspak të mos gjindetë i randë e j vonuoshim , tue e përciellë horë mb orë e sod mbë nesër ;	E ashtu edhe thotë , se gjithherë e kuurdota , në çdo kohë e orë të ditës e të natës të jetë grishur e thirrur më ndonjë këso të shenjta sakramentesh , aspak të mos gjendet i rëndë e i vonueshëm , dukee përcjellë orë më orë e sot më nesër ;
e aqë maa tepërë mb atë herë , kuur sheh , se ashtë kafsha për të çpejtë , po mb ate ças gaatii të gjindetë ,  ashtu qi si vetëvetëhenë e shpiirtinë e vet ashtu as ndoonjë tjetër të mos venë m perikulli-të mortsë amëshuome – tue i mpsuom ashtu ende e bukur tue u a shtiim ndë mend gjithë famulliisë e populli-të vet , t madhit e t vogëlit , qi gjithë herë e ndë gjithë koho , qi të goditnjë ashtu zyra , as për ndoonjë tjetër kafshë atë të mos e laanë , ashtu as të mos e përciellënë ditë mbë ditë e sod mbë nesër , po mb atë ças e maa çpejt , qi të mundnjënë , të vinjënë me e grishunë .	e aq më tepër më atë herë , kur sheh , se është gjëja për të shpejtë , po më atë çast gati të gjendet , ashtu që si vetveten e shpirtin e vet ashtu as ndonjë tjetër të mos venë në rrezik të mortjes së amshuar duke i mësuar ashtu edhe e bukur duke ua shtirë në mend gjithë famullisë e popullit të vet , të madhit e të voglit , që gjithherë e në gjithë kohët , qi të goditnjë ashtu zyra , as për ndoonjë tjetër gjë atë të mos e lënë , ashtu as të mos e përcjellin ditë më ditë e sot më nesër , po më atë ças e më shpejt , që të mundin , të vijnë për ta grishur .
E ashtu ende gjithë herë , qi të nisetë me shërbyem ndoonjë kënco shinte sakramentesh , nd a njintë e ndë pastë kuur , maa parë të bierë pakëzë mbë gjunjë e të banjë uratë oo me gojë oo veçëse me zemërë e të kujtuom , mirë tue vuum roe vetë ndë vetëhe e tue kujtuom , se pa ku a nisunë , oo qish do me baam , e ndër të ciat kafshë aty do me u përziem , oo përpara së kuujsë faqe do me u kallëzuom .	E ashtu edhe gjithherë , që të niset për të shërbyer ndonjë këso të shenjta sakramente , në a njintë e në pastë uur , më parë të bjerë pakëz më gjunjë e të bëë uratë o me gojë o veçse me zemër e të kujtuar , mirëduke vënë re vetë në vete e suke kujtuar , se pa ku është nisur , o qysh do të bëjë , e ndër të cilat gjëra aty do të përzihet , o përpara së kujt faqe do të kallëzohet .
Ani ndeevonë veshunë maa pak kotënë e stolënë përmbii ta – jashtë ncë rrëfyemit , qi , kuur godit ashtu zyra , kedo të jeetë e sido të ndodhetë , ashtu duhetë me ndenjunë e me e ndëgjuom ende paa të tjera çerimonie , – e mbë të tjerat shinte sakramente gjithëherë i duhetë të kietë maa pak një gjakon ndaj vetëhenë oo , – sikundrëse a vendi , e qish sakrament të jeetë , – dy oo tre bukur parequom e m kotët veshunë , si u kaa hie .	Ani më vonë veshur më pak veladonin e stolën përmbi të – jashtë së rrëfyerit , që , kur godit ashtu zyra , kudo të jetë e sido të ndodhet , ashtu duhet të rrijë e ta ndëgjuem edhe pa të tjera ceremoni , – e më të tjerat të shenjta sakramente gjithherë i duhet të ketë më pak një dhjak ndaj veten o , – sikundërse është vendi , e qysh sakrament të jetë , – dy o tre bukur parequom e me veladonin veshur , si u ka hije .
E ashtu ende fort mirë të venë roe prifti , qi paramentetë e petëkatë e napëtë e gjithë të tjeratë eenë e saa kafshë duhenë nd atë shinte shërbëtyrë të jeenë gjithë të tana e t ungjina e të mpastra e të dëlira , si duhetë .	E ashtu edhe fort mirë të vënë re prifti , që paramanat e petkat e napat e gjithë të tjerat jenë e sa gjëra duhen në atë të shenjtë shërbim të jenë gjithë të tëra e t ungjina e të pastra e të dëlira , si duhet .
E ashtu ende gjithë herë , qi shërben ndoonjë kënco shinte sakramentesh , – çerimoniatë , zakonetë e të mirëtë e vërtytnë e tyne e , se qish kafshë shëmënjenjënë e shinjifikonjënë , aqë saa mundën e saa i vie-n dore me komodita-të vet t a nçelnjë e t a kallëzonjë gjithëkuujnaaj , posikundrëse Concilio Tridentino e shintënitë atë e katekismi i Romësë kanë urdhënuom e ndërequnë .	E ashtu edhe gjithherë , që shërben ndonjë këso të shenjta sakramente , – ceremonitë , zakonet e të mirët e virtytin e tyre e , se qysh gjëra shëmënjenjënë e shinjifikonjënë , aq sa mundin e sa i vjen dore me komodita të vet ta çelë e ta kallëzojë gjithkujt , posikundërse Concili Trentin e shenjtët etër e katekizmi i Romës kanë urdhëruar e ndrequr .
E gjithë sakrament ashtu ende qi të marrënë me shërbyem , maa tepërë përmbii gjithë kafshët të kienë të madh kujdes e të nzyyrunë përmbii formë-të tii e ato shinte fjalë , qi lidhnjënë e konshekronjënë , tue i thanë gjithë me mend e me shqise e fort bukurë e gojëplot daam e kthiem njanënë n tieteret e gjithë plot me frikët e tmeer-të Tinëzot ndë vetëhe .	E gjithë sakrament ashtu edhe që të marrin për të shërbyer , ma tepër përmbi gjithë gjërat të kenë të madh kujdes e të nzyyrunë përmbi formë të tij e ato të shenjta fjalë , që lidhin e konsakrojnë ,  duke i thënë gjithë me mend e me shqisa e fort bukur e gojëplot ndarë e kthyer njaërën në tjetrën e gjithë plot me frikë e tmer të Tinëzot në vete .
E ashtu ende gjithë saa uratë e të lutuna e kafshë të tiera janë ndërequnë e urdhënuom , aspak të mos i thoetë veçëse për mend e sikuur për të ngutunë oo për të harruom , – posikundrëse kanë mpsuom gojënë disa të paafat , qi as gjymsëtë s u thonë , – po bukur hieshim e gjithë për letërë tue i shukuom e kaadaleth , si do ligja , paa ndoonjë të ngutunë e të përzienë .	E ashtu edhe gjithë sa uratë e të lutura e gjëra të tjera janë ndrequr e urdhënuar , aspak të mos i thuhet veçse për mend e sikur për të ngutur o për të harruar , – posikundërse kanë mësuar gojën disa të pafat , që as gjymsëtë s'u thonë , – po bukur hieshëm e gjithë për letër dukei shikuar e ngadalë , si do ligja , pa ndonjë të ngutur e të përzier .
E të tjeratë kafshë e çerimonie me t atiat shqise e devocione e të prunjëtë t i banjë , saa gjithëkush të ndodhetë aty me j a gjegjunë , të mbushenë plot me devocione e dëshirit së qiellet , tue lëvduom e tue përlëvduom atë zo-të mëshëriershim , qi i kaa baam , ndërequnë e urdhënuom .	E të tjerat gjëra e ceremoni me të atilla shqisa e devocione e të përulët t'i bëjë , sa gjithkush të ndodhet aty t'ia dëgjojnë, të mbushen plot me devocione e dëshirë të qiellit , dukë lëvduar e duke përlëvduar atë zot të mëshirshëm , që i ka bërë , ndrequr e urdhëruar .
E ashtu ende gjithë herë , qi të doë me u afruom e me shërbyem ndoonjë kënco kafshësh , for-të ruhetë , mos marrë me nçtuom oo me përziem ndoonjë tjetër kafshë , qi di , se s përket asaaj shërbëtyre ;	E ashtu edhe gjithherë , që të dojë t'u afrohet e tëshërbyjë ndonjë këso gjërash, fort të ruhet , mos marrë të shtojë o tëpërziejë ndonjë tjetër gjë, që di , se s'i përket asaj shërbese ;
po gjithë mendnë e shqisenë e vet t a kietë të  plotë mb atë shërbëtyrë , qi ashtë tue baam , e jo mbë tjetërë , oo ndë mose , ndoonee tue kujtuom e tue e pasunë zemërënë e vullëndetnë me e mbaruom atë kafshë ashtu , posikundrëse shinteja ama kishë kaa urdhënuom e ndërequnë , e jo ndryshej .	po gjithë mendjen e shqisën e vet ta ketë të plotë më atë shërbesë , që është duke bërë , e jo më tjetër , o në mos , ndoonee duke kujtar e duke e pasur zemrën e vullnetin për ta mbaruar atë gjë ashtu , posikundërse e shenjta ama kishë ka urdhëruar e ndrequr , e jo ndryshe .
E ashtu ende for-t a shtierë ndë mend e të ruhetë gjithëkush , qi ndë të shërbyemi-të këtyne shinteve sakramente asndoonjë pagëtyrë të mos lypetë , mos pari , mos mbrapa , – po të jeenë shërbyem fort bukur hieshim e me saa të denja e të dërejta arrësenje , fort daam e larguom n gjithë rrembashit së lakëmiisë e ncë simoniisë e anco kafshësh , qi aty as me ndoonjë arrësye s janë për hie me qenë përziem e përmendunë .	E ashtu edhe fort ta shtjerë në mend e të ruhet gjithkush , që në të shërbyerit të këtyne të shenjtave sakramente asndonjë shpërblim të mos lypet , mos para , mos mbrapa , – po të jenë shërbyer fort bukur hieshëm e me sa të denja e të drejta arsye , fort ndarë e larguar në gjithë rrembashit së lakmisë e së simoniisë e aso gjërash, që aty as me ndonjë arsye s'janë për hije me qenë përzier e përmendur .
Maa mb atë herë , kuur ndoonja me vullënde-të vet do me dhanë gjaakafshë sikuur për lëmoshënë e jo për pagëtyrë mbë disa vise , ke ashtu ashtë zakoni , këjo ende paa mkat munë merretë , veçëse ndryshej nd i duktë upeshkëpit , qi të mos e urdhënonjë .	Ama më atëherë , kur ndonjë me vullnet të vet do të japë gjëkafshë sikur për lëmoshën e jo për shpërblim më disa vise , ku ashtu është zakoni , kjo edhe pa mëkat mund të merret , veçse ndryshe në iu duk ipeshkvit , që të mos e urdhërojë .
E ashtu ende i ciecilli prift for-të ruhetë , qi këto shinte sakramente as me ndoonjë arrësye mos i shërbenjë kund ndë ndoonjë tjetër famullii jashtë vendit e famulliet së vet , – veçëse ndë goditë aqë e madhe nevojë , qi të mos mundej ndryshej me u baam , oo të jeetë me urdhëni- të vikarit oo të parokianit e të priftit , qi ashtë  ati i shpiirtit e bariu i tyne .	E ashtu ende secili prift fort të ruhet , që këto të shenjta sakramente as me ndonjë arsye mos i shërbejë kund në ndonjë tjetër famulli jashtë vendit e famullisë së vet , – veçse në godittë aq e madhe nevojë , që të mos mundej ndryshe të bëhej , o të jetë me urdhrin e vikarit oo të rektorit e të priftit , që është ati i shpirtit e bariu i tyre .
E kshtu ende arrësye ish , qi prifti gjithë herë famullisë përpara të u a kallëzon ditënë e motnë e horënë e çasnë , kuur kanë ndë mend me i përzanë këto shinte sakramente , for-tue i mpsuom e tue i ndishkuom , qi mb atë herë maa tepërë se kuurraaj të jeenë jo veçëse gjithë mkateshit e palaviishit së korpit shtëmangunë e larguom , po ashtu ende n gjithë saa dëshiresh e ncë kujtuomesh e përrallësh e fjalëshit së mbrazëtash , – e gjithë ndë frikët e tmeer-të Tinëzot e jo me j përzanë keq e paahieshim e paa ndoonjë devocione , posikundrëse mbë disa vise janë mpsuom disa të paafat , qi veçëse sikuur thuose me baam zakonë e tue u përraallunë njani me tjetërit me saa fjalë të mbrazëta paa ndoonjë shkëndii friket e tmeerjet së Tinëzot ndë vetëhe ;	E kështu edhe arrësye ish , që prifti gjithherë famullisë përpara t'ua kallëzojë ditën e motin e orën e çastit , kur kanë në mend t'i përzënë këto të shenjta sakramente , fort duke i mësuar e duke i ndëshkuar , që më atë herë më tepër se kurrë të jenë jo veçse gjithë mëkateve e palavive të korpit shmangur e larguar , po ashtu edhen gjithë sa dëshirash e së kujtuarish e përrallash e fjalësh së zbrazëtash , – e gjithë në frikë e tmerr të Tinëzot e jo t'i përzënë keq e pahijshëm e pa ndonjë devocion , posikundërse më disa vise janë mësuar disa të pafat , qi veçse sikur thuase për të bërë zakonin e duke u përrallur njëri me tjetërin me sa fjalë të zbrazëta pa ndoojë shkëndijë frike e tmerrit së Tinëzot në vete ;
e këjo munë thomi , se ashtë fajtë e priftënet , qi s i kanë maa m pari qërtuom e msuom e vuum mb udhë .	e kjo mund të themi , se është faji i priftërve , që s'i kanë më m pari qortuar e mësuar e vënë më udhë .
Ashtu ende aty , ke di , se ashtë zyra , e duhetë kush ashtë ati i shpiirtit e bariu i popullit këtë shinte letërë t a kietë gjithëherë ndaj vetëhenë e , tue ecunë pr urdhëni- të saaj , gjithë kafshënë t a shërbenjë , posikundrëse mbrenda t a gjeenjë shkruom e urdhënuom .	Ashtu edhe aty , ku di , se është zyra , e duhet kush është ati i shpirtit e bariu i popullit këtë të shenjtë letër ta ketë gjithherë ndaj vetes e , duke ecur për urdhëri të saj , gjithë gjënë ta shërbejë , posikundërse brenda ta gjejë shkruar e urdhëruar .
E të dijë gjithëkush , se këtu s janë vuum gjithë shintetë sakramente , veçëse pjesë ncosh , me të gjithë rubrikët e çerimonia-të tyne , qi ashtë ma i pari : të pagëzuomitë , 2. të rrëfyemitë oo peendesa , 3. të kunguomitë shint , 4. të vojuomitë shint , qi banetë ndë fii- të mortsë , 5. matrimoni , qi ashtë të vuumitë kunorë e të shoqënuomitë e burrit e të gruosë me të beekuomi-të shintesë kishë katolike .	E të dijë gjithkush , se këtu s'janë vënë gjithë të shenjtat sakramente , veçse pjesë syresh , me të gjitha rubrikat e ceremoni të tyre , që është më i pari : të pagëzuarit , 2. të rrëfyerit oo pendesa , 3. të kunguarit të shenjtë , 4. të vajuarit të shenjtë, që bëhet në fii të mortjes , 5. martesa, që është të vënët kurorë e të shoqëruarit e burrit e të gruas me të bekuarit të së shenjtës kishë katolike .
E dyy të tjera , qi ashtë : të krezmuomitë e urdhëni shint – tue qenë ato oficia e upeshkëpit , janë vuum ndë pontifikall- të tii e jo ndë këtë , ke s duhenë .	E dy të tjera , që është : të krezmuarit e urdhri i shenjtë shint – duke qenë ato zyra e ipeshkëvit , janë vënë në pontifikall- të tij e jo në këtë , ku s'duhen .
E kush të dëshëronjë ende maa të tjera kafshë me njofunë e me diijtunë për ndimë-të këtyne shinteve sakramente , le të marrë kshiill e të mpsuom saa ncë tiera letërash , e aqë maa tepërë katekismit së Romësë oo shinteshit kanone ;	E kush të dëshirojë edhe më të tjera gjëra të njohë e të dijë për ndihmë të këtyre të shenjtave sakramente , le të marrë këshillëë e të mësuar sa së tjera letrash , e aq më tepër katekizmit së Romës o të shenjtave kanune ;
përse ketu maa të tiera kafshë s i janë vuum jashtë ancosh , qi perkasënë këtyne pesë sakramenteve , qi thashë përsiperi .	përse këtu më të tjera gjëra s'i janë vënë jashtë asosh , që u perkasin këtyre pesë sakramenteve , që thashë përsipër .
Maa ligja ashtë , qi gjithëkush shërben këto shinte sakramente ndë kishë-të Tinëzot , i duhetë të kietë gjithë saa duor letërash di , se përkasënë asaaj oficiesë e ndeersë tii , e ashtu ende trajtuom e baam gaatii një letërë të madhe të paashkruome , ndë të ciit të munë shkruonjë e të shënonjë gjithë saa foshnjë të pagëzonjë e ditënë e vietëtë e emënatë e tyne , të prindet e të kumëtret , e ashtu ende gjith ata , qi t u venë kunorë , e ata , qi të vdesënë famulliet e populliet së tii , – posikundrëse ndë të sosmi-të kësaaj letëre , ndë dashtë Zotyynë , kemi ende maa plot me i ndërequnë e me e thanë gjithë kafshënë .	Por ligji është , që gjithkush shërben këto të shenjta sakramente në kishë të Tinëzot , i duhet të ketë gjithë sa duar letrash di , se i përkasin asaj oficiesë e nderit të tij , e ashtu edhe trajtuar e bërë gaati një letër të madhe të pashkruar , në të cilën të mund të shkruajë e të shënojë gjithë sa foshnjë të pagëzojë e ditën e vjetët e emrat e tyre , të prindërve e të kumtërve , e ashtu edhe gjithë ata , që t'u vënë kurorë , e ata , që të vdesin në famulliinë e popullin e tij , – posikundërse në të sosurit e kësaj letre , në dashtë Zoti ynë , kemi edhe më plot për t'i ndrequr e për ta thënë gjithë gjënë .
Maa parë shintit sakramentit së t pagëzuomit .	Më parë të shenjtat sakramente së të pagëzuarit .
Këta shint të pagëzuom s munë thomi , se ashtë tjetër veçëse të zanëtë fiill të shintesë fee e dera e jetësë amëshuome .	Këta të shenjtë të pagëzuar s'mund të themi , se është tjetër veçse të zënëë fill të së shenjtës fe e dera e jetës së amshuar .
I cilli ndër gjithë sakramente- të tjera të ligjsë ree prej Krishtit së mëshëriershim qe urdhënuom e ndërequnë e mbaa vendnë maa të parënë për të shelbuomi-të shekullit – posikundrëse aj vetë kësaaj fjale po j dëshmon ndë shintit ungjiill-të vet , tue thanë , se : Nisi quia renatus fuerit ex aqua & Spirito sancto , non potest introire in regnum Dei , – sikuur thuose : paa mos leem nieerii të dyyjtënë herë me ujët e me Shpiirtit Shint , aspak s munë hiinjë ndë regjënii-të qiellet .	I cili ndër gjithë sakramente të tjera të ligjit të ri prej Krishtit së mëshirshëm qe urdhëruar e ndrequr e mban vendin më të parën për të shëlbuarit të dheut – posikundërse ai vetë kësaj fjale po i dëshmon në të shenjtin  ungjill të vet , duke thënë , se : Nisi quia renatus fuerit ex aqua & Spirito sancto , non potest introire in regnum Dei , – sikur thuase : pa lerë njeri të dytën herë me ujët e me Shpirtin e Shenjtë , aspak s'mund të hyjë ndë mbretëri të qiellit .
Praashtu posikundrëse ata , qi e shërbenjënë ,  ashtu ende gjith ata , qi e përzaanë e e marrënë , – tue qenë këjo dera e kryetë e gjithë kafshësë për të shelbuom , duhetë qi të jeetë shërbyem e marrë me të madhe shpëresë e të prunjëtë e devocione , ashtu qi t u jeetë njanësë lagje ende tjetërësë për të madhe ndimë e dobii të shpiirtit .	Pra ashtu posikundërse ata , qe e shërbejnë , ashtu edhe gjithë ata , që e përzënë e e marrin , – duke qenë kjo dera e kryet e gjithë gjësë për të shelbuar , duhet që të jetë shërbyer e marrë me të madhe shpresë e të prunjëtë e devocione , ashtu që t'u jetë njërës lagje edhe tjetrës për të madhe ndihmë e dobi të shpirtit .
E ati i shpiirtit oo kushdo tjetër t a shërbenjë këtë shint sakrament , mirë duhetë t i dijë [ Svane: die ] e t i njoho , se të tjera janë kafshëtë necessarie prej Sinëzot urdhënuom për shërbëtyrët të këtii shinti sakramenti , posi ashtë materia , forma , minister – e të tjera janë ato , qi përkasënë t atiillt gazimendi e ngushëllimi t paasosuni , posikundrëse ashtë zakoni e çerimonietë , të ciatë qysh moti shintitë apostuj me saa të denja e të dërejta arrësenje i kanë urdhënuom e ndërequnë ;	E ati i shpirtit o kushdo tjetër ta shërbenjë këtë të shenjtë sakrament , mirë duhet t'i dijë [ Svane: die ] e t'i njohë , se të tjera janë gjërat necessarie prej Sinëzot urdhëruar për shërbesë të këtij të shenjti sakrament  , posi është materia , forma , minister – e të tjera janë ato , që i përkasin të atillë gazmendi e ngushëllimi të pasosur , posikundërse është zakoni e ceremonitë , të cilat qysh moti të shenjtët apostuj me sa të denja e të drejta arrësenje i kanë urdhëruar e ndrequr ;
të ciatë aspak me ndoonjë arrësye s duhetë me qenë shkuom e lanë , veçëse ndë goditë ashtu ndoonja aqë e madhe nevojë , qi maa të mos kietë si me e baam .	të cilat aspak me ndonjë arsye s duhet të shkojnë e të lihen , veçse në godittë ashtu ndonjë aq e madhe nevojë , që më të mos ketë si ta bëjë .
Praashtu tashti këtu kënco kafshësh desha me folë e mirë me u a shtiim ndë mend , qi kyy shint sakrament , sikundrëse ashtë zakoni , bukur hieshim e me saa të dërejta arrësenje të jeetë shërbyem e ndeerunë : posikuur të zanëtë fiill të shintesë fee e kryetë e gjithë kafshëvet për të shelbuom .	Pra ashtu tashti këtu këso gjërash desha të flas e mirë për t'ua shtirë në mend , që ky i shenjtë sakrament , sikundërse është zakoni , bukur hieshëm e me sa të drejta arsye të jetë shërbyer e nderuar : posikur të zënët fill të së shenjtës fe e kryet e gjithë gjërave për të shëlbuar .
Maa parë materiet .	Më parë materiet .
Maa parë mirë t a njoho e t a dijë prifti , qi përzihetë nde këtë shinte shërbëtyre , se materia e këtii shinti sakramenti tjetër s ashtë veçëse ujetë e bukur e të kulluom paa ndoonjë tjetër të përzienë ndë vetëhe , veçëse ashtu sikundrëse ashtë dhanë Sinëzot .	Më parë mirë ta njohë e ta dijë prifti , që përzihet në këtë të shenjtë shenjtë shërbesë , se materia e këtij të shenjti sakrament tjetër s'është veçse uji i bukur e i kulluar pa ndonjë tjetër të përzier në vete , veçse ashtu sikundërse është dhënë Sinëzot .
Maa ujëtë e atii t pagëzuomi , qi banetë me solemnità , sikuur thuose gëzuoshim e me kumëtrë e me ndrikullë ndë kishë-të Tinëzot , – ata ujë duhetë me qenë maa pare beekuom të shëtunë e madhe oo të shëtunë e rshajevet , posikundrëse ashtë zakoni , e ruojtunë ndë fontë-të parequome for-të mpastrë e të dëlirë , si do ligja e Krishtit , ashtu qi të jeetë ndë gjithë vjetët e gjithëherë gaatii , aty e vien moti e koha me beekuom tjetërinë ;	Por ujët e atij të pagëzuari , që bëhet me solemnità , sikur thuase gëzuashim e me kumtër e me ndrikullë në kishë të Tinëzot , – ai ujë duhet të jetë më parë bekuar të shtunën e madhe o të shtunën e rrëshajëve , posikundërse është zakoni , i ruajtur në pagëzore të parequome fort të pastër  e të dëlirë , si do ligji i Krishtit , ashtu që të jetë në gjithë vjetët e gjithherë gati , aty e vjen moti e koha për ta bekuar tjetrin ;
e mb atë herë qish të jeetë tepëruom , duhetë me qenë shtiim ndë fontët të madhe të baptisterit , ke të jeetë vendi trajtuom , oo kund mbë qishdo tietër ven-të dëlirë ndë kishë-të Tinëzot .	e më atë herë qysh të jetë tepruar , duhet të jetë shtirë në pagëzore të madhe të baptisterit , ku të jetë vendi trajtuar , o kund më qyshdo tjetër vend të dëlirë në kishë të Tinëzot .
E mb atë herë , kuur të shoho , se ndë vjetët mer me menguom , aty mun i nçtonjë pakëzë tjetër ujë , qi të mos e lanë të thahetë , – maa jo shumë , po pakëzë .	E më atë herë , kur të shohë , se në vjetët merr të mungojë , aty mund t'i shtojë pakëz tjetër ujë , që të mos e lërë të thahet , – por jo shumë , po pakëz .
Maa mb atë herë , kuur t ish derdhunë paa hiir oo marrë eerë e çartunë oo mbë qishdo tietër arrësye meenguom , aty prifti përsërii , mbasi t a kietë bukur laam e dëliirm fontënë , t a mbushnjë përsërii me ujë të bukurë e të kulluom , ani të zanë fiill t a beekonjë , posikundrëse ashtë këtu vuum për fundit .	Por më atë herë , kur të ish derdhur pa hir o marrë erë e çartur o më qyshdo tjetër arsye mangët , aty prifti përsëri , mbasi ta ketë bukur larë e dëlirë pagëzoren , ta mbushë përsëri me ujë të bukur e të kulluar , ani të zërë fill ta bekojë , posikundërse është këtu vënë për fundi .
E mb atë herë , kuur sheh , se ujëtë e fontësë kaa ngriim e baam akullë , aty mun a çkriinjë me pak tjetër ujë të nxeetë , ashtu si të mundnjë me mbaruom zyrënë e oficienë e vet me arrësye e të mos venë foshnjënë m perikullë .	E më atë herë , kur sheh , se ujët e pagëzores ka ngrirë e bërë akull , aty mund ta shkrijë me pak tjetër ujë të nxehtë , ashtu si të mundë për të mbaruar detyrën e oficienë e vet me arsye e të mos vërë foshnjën më rrezik .
E ashtu ende e dyyjta kafshë n krye e këtii shinti sakramenti ashtë forma , – e cia s ashtë tjetër veçëse ato shinte fjalë , qi thotë prifti aty mb atë herë , kuur ndoonja tue pagëzuom përnjëherë tue i qitunë ujëtë majë kreesë jet e j thotë , se : Ego te baptizo in nomine Patris & Filii & Spiritus Sancti , – e këjo kshtu duhetë me u thanë gjithëherë , e jo ndryshej oo mbë tjetër arrësye e jo tjetër herej oo ndë tjetër koho , po mb atë herë , kuur për njëherë n kryq tue i shtiim ujëtë majë kreesë , sikundrëse ashtë zakoni i t pagëzuomit .	E ashtu edhe e dyta gjë në krye të këtij të shenjtë sakramenti është forma , – e cila s'është tjetër veçse ato të shenjta fjalë , që thotë prifti aty më atë herë , kur ndonjë duke pagëzuar përnjëherë duke i qitur ujët majë kryet rri e i thotë , se : Ego te baptizo in nomine Patris & Filii & Spiritus Sancti , – e kjo kështu duhet të thuhet gjithherë , e jo ndryshe o më tjetër arsye e jo tjetër herë o në tjetër kohë , po më atë herë , kur përnjëherë  në kryq duke i shtirë ujët majë kryet , sikundërse është zakoni i të pagëzuarit .
E mirë se këjo fjalë munë dishqaaronetë me u thanë mbë tjetër gjuhë , asgjaamangu prifti i lëtinë e j arbëneshë aspak s duhetë ndryshej me e nkthyem as me e ndërruom , po ashtu për letërë , sikundrëse ashtë shkruom e urdhënuom .	E mirë se kjo fjalë mund të dishqaaronetë për t'u thënë më tjetër gjuhë , asgjëmangu prifti i latin e i arbëresh aspak s'duhet ndryshej ta kthejë as ta ndërrojë , po ashtu për letër , sikundërse është shkruar e urdhëruar .
E këta shin-të pagëzuom si të jeetë baam një herë , aspak për së dyyjtë maa s munë përtërihetë , veçëse ndë qoftë ashtu ndoonjë të menduom , qi të mos diheej mirë , se a munë jeetë pagëzuom oo jo ;	E këta të shenjtë të pagëzuar si të jetë bërë një herë , aspak për së dytë më s'mund të përtërihet , veçse në qoftë ashtu ndonjë të menduar , që të mos dihej mirë , se a mund të jetë pagëzuar o jo ;
të këtiitë mbë këtë arrësye ke gjindenë , me këtë kondicione duhetë me i pagëzuom mbas gjithë kafshëshit së tjëra , tue i shtiim ujëtë përmbii krye , këtë fjalë mbë këtë arrësye me j a thanë , se : Si non es baptizatus , ego te baptizo in nomine Patris & Filii & Spiritus Sancti . E kshtu , ndë mos qe pagëzuom , me kaqë kish me qenë pagëzuom e ndë numuri-të kërshtenëvet .	të këtillët më këtë arsye ku gjenden , me këtë kondicione duhet të pagëzohen mbas gjithë gjërash të tjera , duke i shtirë ujët përmbi krye , këtë fjalë më këtë arsye për t'ia thënë , se : Si non es baptizatus , ego te baptizo in nomine Patris & Filii & Spiritus Sancti . E kështu , në mos qe pagëzuar , me kaq do të kish qenë pagëzuar e në numer të të krishterëve .
E thotë , se këta shin-të pagëzuom , posikundrëse ke ashtë zakoni , duhetë me qenë baam oo me të qituni- të ujit përmbii krye , posikundrëse thashë përsipëri , oo me të lagunit e të qituni-të gjithë korpit nd ujët ;	E thotë , se këta të shenjtë të pagëzuar , posikundërse ku është zakoni , duhet të jetë bërë o me të qitur  të ujit përmbi krye , posikundërse thashë përsipër , o me të lagurit e të qiturit të gjithë trupit në ujë ;
e këto të dya mëjaft janë , sikundrëse ke a zakoni , oo trii herë n kryq tue i qitunë ujë permbii krye oo n kryq tue e lagunë gjithë nd ujët , përnjëherë tue i thanë këto shinte fjalë të formësë , qi thamë përsipëri , – aj mb atë arrësye ashtë pagëzuom .	e këto të dyja mëjaft janë , sikundërse ku është zakoni , o tri herë në kryq duke i qitur ujë përmbi krye o në kryq duke e lagur gjithë në ujë , përnjëherë duke i thënë këto të shenjta fjalë të formës , që thamë përsipër , – ai më atë arsye është pagëzuar .
E aty ke bahetë pagëzimi me të shtiimi-të ujit , for-të ruhetë , qi ata ujë mos nkthenjë përsërii me raam nd ujë- të fontësë , po ndë tjetërët fontë të baptisterit ndaj ata trajtuom , oo ndë qishdo tietër anë pr atë shërbëtyrë ndërequnë , e ndeevonë oo shtiim ndë sakrariet oo mbë tjetër vend pr atë arrësye parequom .	E aty ku  bëhet pagëzimi me të shtirë të ujit , fort të ruhet , qq ata ujë të mos kthejë përsëri për të rënë në ujë të pagëzores , po në tjetër pagëzore të baptisterit ndaj ata trajtuar , o në qyshdo tjetër anë për atë shërbesë ndrequr , e më vonë o shtirë në sakrariet o më tjetër vend për atë arsye parequom .
E e treta kafshë n krye e këtii shinti sakramenti ashtë : minister , qi s ashtë tjetër veçëse prifti oo qishdo tjetër nd urdhënit shint prej nci co prej vikarit së vendit urdhënuom .	E e treta gjë në krye të këtij të shenjti sakrament është : minister , që s'është tjetër veçse prifti o kushdo tjetër në urdhrin e shenjtë prej nci co prej vikarit të vendit urdhëruar .
E këjo ndëgjonetë mb atë herë , kuur duketë , se s ashtë ndoonjë nevojë .	E kjo kuptohet më atë herë , kur duket , se s'është ndonjë nevojë .
Maa kuur t ish ashtu nevoja , sikuur thuose foshnja m perikullë me shkuom paa pagëzuom , – aty gjithëkush kaa të lirë e mundën me e pagëzuom , sidota e mbë qishdo gjuhu të jeetë , oo prift oo gjakon oo sekulaar , e se makaar t ish ndoonji i skomunikuom oo i pëganë e j paafee , oo burrë oo gruo të jeetë , – veçëse të diij e t ish i zoti me shërbyem materienë e formënë , qi thamë përsipëri , tue pasunë ndë mend me mbaruom , qish kisha shinte kaa urdhënuom .	Po kur të jetë ashtu nevoja , sikur thuase foshnja më rrezik të shkojë pa pagëzuar , – aty gjithkush ka të lirë e mund ta pagëzojë , si do ta e më qyshdo gjuhë të jetë , o prift o dhjak o shekullar , e se makar t'ish ndonjë i skomunikuar o pagan e i pafe , o burrë o grua të jetë , – veçse të dijë e të jetë i zoti të shërbejë materien e formën , që thamë përsipër , duke pasur në mend për të mbaruar , qysh kisha e shenjtë ka urdhëruar .
Maa thotë , se , ke gjindetë prifti , aty gjakoni s duhetë me pagëzuom ;	Por thotë , se , ku gjendet prifti , aty dhjaku s'duhet të pagëzojë ;
e ashtu ende , ke gjindetë gjakoni , ndoonjë sekulaar ;	e ashtu edhe , ku gjendet dhjaku , ndonjë shekullar ;
oo ke gjindetë burrë , aty gruoja s duhetë me pagëzuom – veçëse ndë qoftë kafsha aqii mbarreje mb atë herë , kuur foshnja ashtë tue leem , e të mos mundetë aty burrë me u afruom , oo mb atë herë , kuur gruoja ashtë maa vesht e e di maa mirë materienë e formënë me fjalët , qi thamë përsipëri , e ashtë e zotnja maa plot e maa mirë me e pagëzuom .	o ku gjindet burrë , aty gruaja s'duhet të pagëzojë – veçse në qoftë gjëja aq turp më atë herë , kur foshnja është duke lerë , e të mos mundet aty burrë të afrohet , o më atë herë , kur gruaja është më e zgjuar e di më mirë materien e formën me fjalët , që thamë përsipër , e është e zonja më plot e më mirë ta pagëzojë .
Prashtu thotë , se prifti gjithë kënco kafshësh duhetë fort me u nzyyrunë e me mpsuom popullinë e famulliinë e vet – e maa tepërë ato graa e plaka amëvisa , qi ndodhenë pakmos mbë gjithë vend , ke lindetë foshnja , – mirë tue u a shtiim ndë mend këtë kafshë , t a dijë [ Svane: die ] gjithëkush , ashtu qi , kuurdo të goditeej ashtu ndoonjë nevojë , të mos vdaareej ndoonjë paa pagëzuom për të paamsuom e të paadiijtunë .	Pra ashtu thotë , se prifti gjithë këso gjërash duhet fort të nzyyrunë e të mësojë popullin e famullinë  e vet – e më tepër ato gra e plaka amvisa , që ndodhen pakmos më gjithë vend , ku lindet foshnja , – mirë duke ua shtirë në mend këtë gjë, ta dijë [ Svane: die ] gjithkush , ashtu që , kurdo të goditet ashtu ndonjë nevojë , të mos humbet ndonjë pa pagëzuar për të pamësuar e të paditur .
E thotë , se j ati e e ama vetë fëmiinë e vet aspak s do ligja me e pagëzuom ;	E thotë , se i ati e e ama vetë fëmijën e vet aspak s'do ligji ta pagëzojnë ;
maa , kuur të shif ashtu ndoonjë nevojë , se foshnja po shkon paa pagëzuom , e kush tjetërë s gjindetë , aty maa si e ban s kaa , po i duhetë t a pagëzonjë paa lidhunë ndë ndoonjë kumëtrii oo të mbaajtunë gjaa pr ata njani me tjetërit .	po, kur të shohë ashtu ndonjë nevojë , se foshnja po shkon pa pagëzuar , e kush tjetër s'gjendet , aty më si t'ia bëjë s ka , po i duhet ta pagëzojë pa lidhur në ndonjë kumëtëri o të mbajtur gjë për ata njëri me tjetrin .
Saa moti e ndë qish koho duhetë foshnja me u pagëzuom .	Sa moti e në qysh kohë duhet foshnja të pagëzohet .
Duhetë prifti bukur t i msonjë popullinë e famulliinë e vet , qi , foshnja posaa leen , maa të parënë kafshë , aqë saa maa çpejt të mundnjënë , t a shpienë n kishët shinte t a pagëzonjënë , sikundrëse do ligja e Krishtit , e jo me vuum ree aqë ndierë nd anët do zakone , qi kanë mbë disa vise , tue e përciellë ditë mbë ditë , ndierë gjeen kuorrë e kohonë e kumëtritë e ndrikullatë , e ndierë ban gatii gostiinë e disa ashtu të tjera madhështii e kafshë të mbrazëta , aqë saa disa herë godit gjukata e keqe e tyne , e ashtu venë paa pagëzuom – mkat aqi i madh e j randë , saa gjuhet së nieriut askuurraaj s mundetë me u kallëzuom , ashtu as munë njëmendetë me ndoonjë tjetër mbë këtë jetë . Praashtu nçil syytë gjithekush , e , saa maa çpejt qi të mundnjësh , t i pagëzojsh paa vuum m perikullë të shelbuomitë e tyne ende të vetëvetëhesë .	Duhet prifti bukur t'i mësojë popullin e famullinë e vet , që , foshnja posa len , më të parën gjë, aq sa më shpejt të mundin , ta shpien në kishën e nsshenjtë ta pagëzojnë , sikundërse do ligja e Krishtit , e jo të vihet re aq deri në anët do zakone , që kanë më disa vise , dukee përcjellë ditë mbë ditë , deri gjer kurrë e kohën e kumtërit e ndrikullat , e deri bën gatii gostinë e disa ashtu të tjera madhështi e gjëra të zbrazëta , aq sa disa herë godit gjukata e keqe e tyre , e ashtu venë pa pagëzuar – mëkat aq i madh e i rëndë , sa gjuhe së njeriut askurrë s'mundet të kallëzohet , ashtu as mund të njëjtësohet me ndonjë tjetër më këtë jetë . Pra ashtu çil sytë gjithkush , e , sa më shpejt që të mundësh , t'i pagëzosh pa vënë në rrezik të shëlbuarit e tyre  edhe të vetvetes .
E mb atë herë , kuur godit kafsha për necessità e pagëzonjënë ndoonja ndë shtëpii për të çpejtë veçëse me formët e me të qituni-të ujit , posikundrëse kemi thanë përsipëri , – t atiinë , ndë qoftë gjaall , ndeevonë t a shpienë n kishë ke prifti , e t i banjë gjithë cerimoniatë e tjera jashtë formet e ncë qitunit së ujit , qi i qenë baam maa m pari ;	E më atë herë , kur godit gjëja për necessità e pagëzojnë ndonjë në shtëpi për të shpejtë veçse me formën e me të qitur të ujit , posikundërse kemi thënë përsipër , – t 'atillin , në qoftë gjallë , pastaj ta shpien në kishë te prifti , e t'i bëjë gjithë cerimonitë e tjera jështë forme e së qiturit të ujit , që i qenë bërë më  parë ;
oo , ndë qoftë ashtu ndoonjë dubitacione e të menduom për të paadiijtunit e të paavesht t atyne , qi e pagëzuonë , persërii tue i qitunë ujëtë , formënë të j a thoetë me atë kondicione , qi thamë përsipëri : Si non es baptizatus , ego te baptizo in nomine Patris &c.	o , në qoftë ashtu ndonjë dyshim e të menduar për të paditurit e të paavesht të atyre , qi e pagëzuan , përsëri duke i qitur ujët , formën t'ia thotë me atë kondicione , që thamë përsipër : Si non es baptizatus , ego te baptizo in nomine Patris &c.
E duhetë ashtu ende me diijtunë , se asndoonja , saa ashtë mbërshelë ndë bark-të s amësë , s munë pagëzonetë .	E duhet ashtu edhe ditur, se asndonjë , sa është mbyllur në bark të s'ëmës , s'mund të pagëzohet .
Maa mb atë herë , kuur duketë , se foshnja kaa qitunë veçëse kryetë jashtë e ashtë m perikulli-të mortsë , ajo aty mb atë arrësye munë pagëzonetë ;	Por më atë herë , kur duket , se foshnja ka qitur veçse kryet jështë e është më rrezik të mortit, ajo aty më atë arsye mund të pagëzohet ;
e ndeevonë , ndë qoftë gjaall , maa s kish me j u dashunë tjetër të pagëzuom veçëse ato uratë e çerimonietë e tjera , qi i mbetnë paa baam .	e më vonë , në qoftë gjallë , më s'kish t'i duhej tjetër të pagëzuar veçse ato uratë e ceremonitë e tjera , që i mbetën pa bërë .
E ndë mos pastë nxierrë kryetë , po qishdo tjetër gjymtyrë , qi të njifetë , se ashtë gjaall e m perikulli – të mortsë , aty mun a pagëzonjë nd atë gjymtyrë ;	E në mos pastë nxjerrë kryet , po qyshdo tjetër gjymtyrë , që të njihet , se është gjallë e në rrezik – të mortjes , aty mund ta pagëzojë në atë gjymtyrë ;
e ndeevonë , ndë leftë gjaall , përsërii me e pagëzuom me atë kondicione e arrësye , qi thamë përsipëri : Si non es baptizatus , ego te baptizo in nomine Patris &c.	e më vonë , në leftë gjallë , përsëri të pagëzohet me atë kondicione e arsye , që thamë përsipër : Si non es baptizatus , ego te baptizo in nomine Patris &c.
E ndë goditi kafsha , qi , mbasi e pagëzuonë nd atë gjymtyrë , leu vdekunë , ajo munë shtiiretë  ndë çemiteer-të kishësë , e jo ndryshej .	E në godittë gjëja, që , mbasi e pagëzuan n atë gjymtyrë , leu i vdekur , ajo mund të shtiret në qimitir të kishës , e jo ndryshe .
E ashtu ende thotë , se mb atë herë , kuur godit kori , qi vdes ndoonjë gruo e ngarkuome – ata , qi janë vesht , mb atë ças t a çkierrënë e të j a nxierrënë jashtë foshnjënë ;	E ashtu edhe thotë , se më atë herë , kur godit kori , që vdes ndonjë grua e ngarkuar – ata , që janë vesht , më atë ças ta çjerrin e t'ia nxierrin jështë foshnjën ;
e nd u ndieftë , se a gjaall , t a pagëzonjënë ;	e në u ndjeftë , se është gjallë , ta pagëzojnë ;
e ndë qoftë vdekunë , qi të mos munë pagëzonetë ;	e në qoftë vdekur , që të mos mund të pagëzohet ;
s do ligja me e shtiim mbë ven-të shekruom .	s'do ligji të shtihet më vend  të shenjtëruar.
E foshnja , qi të gjindeej çkitunë kund e të mos diheej , se oo ashtë pagëzuom oo jo , – t atinë duhetë me e pagëzuom me atë kondicione e arrësye , qi thashë përsipëri , se : Si non es baptizatus , ego te baptizo &c.	E foshnja , që të gjendej shqitur kund e të mos dihej , se o është pagëzuar o jo , – të atillin duhet ta pagëzojmë me atë kondicione e arsye , që thashë përsipër , se : Si non es baptizatus , ego te baptizo &c.
E mb atë herë , kuur godit kori e leen kund ndoonjë moshtrë e ashtu kafshë e shëmtuome , qi s dihetë , se mbë qish arrësye ashtë , – aty mb atë ças të gërshesënë nierëz të diijtëshim , qi t a shohonë , e , si t u duketë , ashtu të banjënë ;	E më atë herë , kur godit kori e len kund ndonjë monstër e ashtu gjë e shëmtuar , që s'dihet , se më qysh arsye është , – aty m atë ças të gërshasin njerëz të ditshëm , që ta shohin , e , si t'u duket , ashtu të bëjnë ;
përse thotë , se moshtra , qi as me ndoonjë shinj nukë shëmënjen me qenë nierii , ajo as me ndoonjë arrësye s munë pagëzonetë .	përse thotë , se monstra , që as me ndonjë shenjë nuk shembëllen të jetë njeri , ajo as me ndonjë arsye s mund të pagëzohet .
Pasëqyra e t rrëfyemit e atit Emerio de Bonis me saa tjera kafshë shumë të frujtuoshime të shpiirtit për ndimë të gjuhu- së arbëneshe e aqë maa tepërë për t atynet , qi s janë të zotë me ndëgjuom gjuhu ncë tjera letërash , nkthyem gjuhet së lëtine mbë gjuhu-t arbëneshe zotit dom Pietrë Budit prej Gurit së Bardhë , upeshkëpit së Zadrimësë .	Pasqyra e të rrëfyemit e atit Emerio de Bonis me sa të tjera gjëra shumë të frytshme të shpirtit për ndimë të gjuhës së arbëreshe e aq më tepër për të atyre , që s'janë të zotë të kuptojnë gjuhë të tjera letrash , kthyer gjuhës së latine më gjuhë të arbëreshe zotit dom Pietër Budit prej Gurit së Bardhë , ipeshkëvit të Zadrimës .
In Roma 1621 .	In Roma 1621 .
Të rekumenduom e të porësitunë upeshktipinjet e vikarinjet e gjithë saa tjerë prelate gjindenë ndë gjuhu-tanë t arbëneshe .	Të rekomanduar e të porositur ipeshkëve e vikarëve e gjithë sa tjerë prelatë gjenden në gjuhën tonë të arbëreshe .
Të ndritshimë e shumë të ndeershimë zotënii e shokë e vëllazënë !	Të ndritshëm e shumë të ndershëm zotërinj e shokë e vëllezër !
Tue dashunë me u nëkuom saa tentacionesh e fëdigësh , qi më kanë gjetunë mbë këtë udhë , druo , se kaa me dukunë kuujnaaj , se duo me u lëvduom .	Duke dashur të ankohem sa përpjekjesh e mundimesh , që më kanë gjetur më këtë udhë , druaj , se ka për t'iu dukur kuujt , se dua të lëvdohem .
E kuur të doe ashtu ende gjaakafshë me u lëvduom , kuur të thom të vërtetënë , – posi mb atë herë i shën Paali i beekuom korintianëvet , – thom , se s dii , a ka me qenë gjaa pr ata i paadiijtunë , mirë tue paam zotënia juoj , se jashtë këncosh ende saa të tjera letëra me dorë të shkruome gjindenë mbë saa vise , qi dëshmonjënë , se saa i madh kaa qenë gjithëherë kujdesi e dëshiri i zemërësë sime për ndimë të Patriesë e të gjuhusë sanë , qi u vduorrë ende po vdaarenë maa të shumënë veçëse për letërë e për të mpsuom .	E kur të dua ashtu edhe gjëkafshë të lëvdohem , kur të them të vërtetën , – posi më atë herë shën Pali i bekuar korintianëve , – them , se s'di , a ka për të qenë gjë për ata i paditur , mirë duke parë zotnia juaj , se jashtë kësosh edhe sa të tjera letra me dorë të shkruara gjenden më sa vise , që dëshmojnë , se sa i madh ka qenë gjithherë kujdesi e dëshira e zemrës sime për ndihmë të athdeut e të gjuhës sonë , që u vdor edhe po vdaret më të shumën veçse për letër e për të mësuar .
E ndeevonë , kuur maa tue paam , se dita qi vjen po maa keq shinteja fee ndër ta vjen tue menguom ;	E pastaj , kur më duke parë , se dita që vjen po më keq e shenjta fe ndër ta vjen duke munguar ;
e shërbëtyra e kishësë Tinëzot , me gjithë saa janë tjerat vepëra të mira , maa tue u shqimbunë e tue u harruom ;	e shërbesa e kishës së Tinëzot , me gjithë sa janë të tjerat vepra të mira , po duke u shqimur e duke u harruar ;
e mbas mortjet së pleqet të riitë maa i lanë gjurmëtë e Krishtit e të apostujet e vepëratë e t kërshtenëvet e u veshnë ndër të t pëganëvet e të t paafeevet ;	e mbas mortjet së pleqve të rinjtë më i lënë gjurmëtë e Krishtit e të apostujve e veprat e të krishterëve e u veshën ndër të të paganëve e të të pafeve ;
e priftënitë , qi duheej me qenë drita e pasëqyra e tyne , – disa lakëmia , disa të paakujdestë e të paadiijtunitë e tyne mbë disa vise i bani me qenë për maa të madh dam e skandullixim e të vdjerrë të tyne , se për qishdo ndimë oo fruj-të mirë të shpiirtit ;	e priftërinjtë , që duhej të ishin drita e pasqyra e tyre , – disa lakmia , disa të pakujdesurit e të paditurit e tyre më disa vise i bëri të jenë për ma të madh dëm e skandullixim e të vdjerrë të tyre , se për çdo ndihmë o fryt të mirë të shpirtit ;
e ashtu ende saa tjera të paanjefuna tue i vuum roe e bukur tue i konsideruom ndë vetëhe , më dukeej , se jam detuor e mbaajtunë gjithëherë – ndo me një arrësye ndo me një tjetërë – kësaaj kafshe me j pruojtunë .	e ashtu edhe sa tjera të panjohura duke i vënë re e bukur duke i konsideruar në vete , më dukej , se jam detorës e mbajtur gjithherë – ndo me një arsye ndo me një tjetër – kësaj gjëje t'i pruhem .
E tue kujtuom se për qish udhë oo me qish arrësye , s më dukeej , se munë banetë për ta tjetër ma e afërë mëngjii se me avizuom e me baam me diijtunë kishënë e Tinëzot e të parëtë e saaj , ke ashtë mpshtetunë e ndimonetë gjithë rrethi i shekullit .	E duke kujtuar se për ç'udhë o me ç'arsye , s më dukej , se mund të bëhet për ta tjetër më e afërt mëngji se me avizuom e duke bërë për të ditur kishën e Tinëzot e të parëtë e saj , ku është mbështetur e ndihmohet gjithë rrethi i botës .
Të ciinë kafshë ende saa tjera plagë të shpiirtit tue i kujtuom , veçë kuur tee i mplasa vikarii e famullii e saa ashtu tjera kafshë , qi për shumë mot mbaajta ndë Shurbiit , e u daashë andej .	Të cilën gjë edhe sa tjera plagë të shpirtit duke i kujtuar , veç kur te i mplasa vikari e famulli e sa ashtu të tjera gjëra , që për shumë mot mbajta në Shurbi , e u ndava andej .
Erdhshë mbë Romë , ke me fjalë e me të shkruome , aqë saa munda , s mengova me avizuom e me baam me diijtunë shintinë atë , papë Paalinë e V. e gjithë të ndritshimenë kolegjënë e gardinajet , të ciitë , mbasi e ndëgjuonë mirë kafshënë , përmetuonë me vuum roe pakëzë , se pa qish mëngjii e rremedie munë banetë .	Në ardhsh në Romë , ku me fjalë e me të shkruara , aq sa munda , s'mëngova me avizuom e t'i bëj të dijë shenjtit atë , papë Palit V. e gjithë të ndritshmin kolegjin e gardinajet , të cilët , mbasi e kuptuan mirë gjënë , premtuan të vënë re pakëz , se pa qysh mëngji e rremedie mund të bëhet .
Maa ndeevonë , disa u tue qenë vetëmë e paavesht aqë ndjerë nd anët , disa tue mos qenë kush ndimë , qishmos kundrështarë e shtiekëqii , asndoonjë kafshë s u mbaruo jashtë anco Doktrine , qi me saa fëdigë e t idhunë mbzii  bana me e shtampuom .	Por më vonë , disa u duke qenë vetëm e paavesht aq deri në anë , disa duke mos qenë kush ndihmë , qyshmos kundërshtarë e shtiekëqinj , asndonjë gjë su mbarua jashtë asaj Doktrine , që me sa mundim e të hidhur mbzii bëra për ta shtypur .
Të ciinë mbasi e dërgova , kuur maa tue paam , se asndoonjë tjetër ndimë s jesh i zoti me baam , i mplasa gjithë kafshëtë e , veshunë si pelegrii , vojta kaha munda me mbërriim , vizitova visetë e devotshime të shintënet e mbusha kushtimetë e baame aty e ndjerë mp shën Jakob të Galiciesë .	Të cilin mbasi e dërgova , kur më duke parë , se asndonjë tjetër ndihmë s'isha i zoti të bëja , i mplasa gjithë gjërat e , veshur si pelegrin , vajta nga munda të mbërrija , vizitova viset e devotshme të shenjtëve e mbusha kushtimet e bëra aty e deri më shën Jakob të Galicisë .
E andej mbas 18 muojsh përsërii mbë Romë tue nkthyem , gjeta letërë atit shumë ncë ndeershim , fra Gjoani Koleshit , upeshkëpit së Arbënit , se Doktrina ajo , ndoonëse me pak fajt tem e të shtampatarëvet , asgjaamangu kaa me qenë ndoonee gjaakafshë për ndimë të atii kërshtënimi .	E andej mbas 18 muajsh përsëri më Romë duke u kthyer , gjeta letër atit shumë të ndershëm , frat Gjoani Koleshit , ipeshkëvit së Arbrit , se Doktrina ajo , ndonëse me pak faj timin e të shtypësve , asgjëmangu ka për të qenë ndonjë gjëkafshë për ndihmë të atij krishtërimi .
Të ciinë kafshë tue e gjegjunë , mb atë ças u mbushçë ende maa tepërë plot me dëshiir , qi ende maa me ashtu qishdo copë letërë me j ndimuom e aqë maa tepërë gjaakafshë për të rrëfyemit , qi die , se mbë disa vise maa u harruo , e , ke s u harruo ende , po pak e rraall shërbenetë , si do ligja .	Të cilën gjë duke e gjegjur , më atë ças u mbusha edhe më tepër plot me dëshirë , që edhe më me ashtu qyshdo copë letër për t'i ndihmuar e aq ma tepër gjëkafshë për të rrëfyer , që die , se më disa vise më u harrua , e , ku s'u harrua ende , po pak e rrallë shërbehet , si do ligji .
Të ciinë kafshë tue e kujtuom , mora për disa dit nktheva një konfesionaar gjuhet së lëtine mbë gjuhu-tanë t arbëneshe . E mbasi e mbarova , suplikova e u lutshë shintit atë Paalit V. , qi përsipëri , a të bante aqë hiir si Doktrinënë me e shtampuom me spenxë të vet .	Të cilën gjë duke e kujtuar , mora për disa ditë ktheva një konfesionar të gjuhës së latine më gjuhën tonë të arbëreshe . E mbasi e mbarova , suplikova e iu luta të shenjtit atë Palit V. , që përsipër , a të bënte aq hir që Doktrinën ta shtypte me shpenzime të veta .
I cilli mirë tue e ndëgjuom kafshënë , j a dërgoj ndë dorë-të mjeshtrit Pëllasit .	I cili mirë duke e kuptuar gjënë , ia dërgoi në dorë mjeshtrit të Pallatit .
E mjeshtri i Pëllasit tue e vuum roe , i shtiu shkag , se qenëkaa kafshë plakë e jo aqi i mirë , s desh me e përzanë , po më dha me nkthyem e me baam një tjetërë .	E mjeshtri i Pallatit duke e vënë re , i shtiu shkak , se qenka gjë e vjetër e jo aq i mirë , s'deshi ta përzinte , po më dha të ktheja e të bëja një tjetër .
Të ciillë mbas disa ditsh ende atë si e mbarova , tue më dukunë kafshë fort e shkurtënë e e mbërshelë për gjuhu-tanë , s më pëlqej , po mora ende këtë të tretënë .	Të cilin mbas disa ditësh edhe atë si e mbarova , duke m'u duku gjë fort e shkurtër e e mbërshelë për gjuhën tonë , s'më pëlqeu , po mora edhe këtë të tretën .
Të ciinë për saa dit mbasi e mbarova , heret së keqe ndeevonë s gjindeej asndoonjë doktuor këtu gjuhet sonë , qi të kish me e paam e me e provuom , si a zakoni .	Të cilën për sa ditë mbasi e mbarova , heret së keqe pastaj s'gjendej asndonjë doktor këtu i gjuhës sonë , që të kish ta shihte e ta provonte , si është zakoni .
E kshtu , mbas saa helmi e nc idhuni ndeevonë m u desh me votë jashtë Romënë ke një frat gjuhet sonë andej Rantësietë , anet së Kruusë .	E kështu , mbas sa helmi e së hidhuri më vonë m'u desh të shkoja jashtë Romës ku një frat i gjuhës sonë andej Rantësietë , anës së Kruusë .
Ke i cilli tue votë me të madh dëshiir posikuur ndoonji i etshim mbë gurrë të ftohotë me u nginjunë , kuur sosa me shpëresë , se kaa me më marrë n grykë e me më ngushëlluom me qishdo fjalë t ambla , sikundrëse ashtë zakoni i fratënet e j priftënet , e aqë maa tepërë kuur mpiqenë kund ashtu si na aty ndë dhee të huoj , mirë tue më njofunë , se kush jam , e kaha jam , e për qish zyrë kam ardhunë .	Ku i cili duke vajtur me të madhe dëshirë posikur ndonjë i etshëm më gurrë të ftohtë për t'u nginjur , kur sosa me shpresë , se ka për të më marrë në grykë e të më ngushëllojë me qyshdo fjalë të ëmbla , sikundërse është zakoni i fretërve e i priftërinjve , e aq më tepër kur piqen kund ashtu si na aty në dhe të huaj , mirë duke më njohur , se kush jam , e nga jam , e për qysh punë kam ardhur .
Pa vini roe , a janë këto fantaziitë e tentacionetë e anëmikut !	Pa vini re , a janë këto fantazitë e përpjkjet e armikut !
Ke saa më paa , se j u afruoshë me j folë , mbasi kishnë dalë vesperi , jo veçëse s desh me folë me muo oo ndë faqet me më shukuom , se a zakoni i n’jerëzet , po ashtu ende më nkthej shpinënë faqe gjithë kuvendit fratënet , mb arrësye të ndoonjii , qi t ish skomunikuom prej papet ;	Ku sa më pa , se iu afrova për t'i folur , mbasi kishin dalë vesperi , jo veçse s'deshi të fliste me mua o në faqe të më shkonte , se është zakoni i njerëzve , po ashtu edhe më ktheu shpinën faqe gjithë kuvendit të fretërve , më arsye të ndonjë , që t'ish shkishëryuar prej pape ;
së ciet madhështii thoshnje , se ende maa tepërë u skandullixuonë fratënitë , shokëtë e tii , qi paanë , se ende saa tierë , qi ndodhnë , e zuunë pakmos me murmëruom kundrë tii me saa fjalë të paagjaana .	së cilat madhështi thoshje , se edhe ma tepër u skandalizuan fretërit , shokëtë e tij , që panë , se edhe sa të tjerë , që ndodhën , e zunë pakmos të mërmëritnin kundër tij me sa fjalë të paagjaana .
E kshtu ndeevonë , disa tue kujtuom gjith aqë fëdigë , qi më dukeej , se bana për të nkotë , disa nevojënë e madhe e të vdierrëtë e atii populli , disa madhështiinë e paa ndoonjë arrësye të këtii frati t paafat , maa tepërë se gjithë kundrështiishit e nevojëshit së tjera , qi më kishnë gjetunë , Zotyynë m a di , se për disa dit desh qi jeshë vdjerrë mallënjimi e nc idhuni , ndjerë qe pëlqyem atii Zotit mëshëriershim me më ngushëlluom ende muo si shumë tjerë të përmpkatënuom , *	E kështu më vonë , disa duke kujtuar gjithë aq mundim , që më dukej , se bëra për të kotë , disa nevojën e madhe e të vdjerrët e atij populli , disa madhështinë e pa ndonjë arsye të këtij frati të pafat , më tepër se gjithë kundrështive e nevojave së tjera , që më kishin gjetue , Zoti ynë ma di , se për disa ditë desh që isha vdjerrë mallëngjimi e së hidhuri , deri qe pëlqyer atij Zotit të mëshirshëm për të më ngushëlluar edhe mua si shumë të tjerë të mëkatëruar , *
E aqëë maa tepërë njaj dite , ke jeshë sikuur dëshpëryem qitunë e raam mbë gjunjë përpara shintit sakrament e ilterit Zotnjësë beekuome ndë Minervët , me saa lot e gjamë e fshanëtime të zemërësë tue e lutunë atë Zo-të mëshëriershim e tue i thanë , se „ O Zoti im shum i ambli e j mëshëriershimi , gazimendi i t idhënuomet e shpëresa e t përmpkatënuomet e ndima e forca e gjith atyne , qi me shpëresë mpshtetenë prej tee ;	E aqë më tepër një dite , ku isha sikur dëshpëruar qitur e rënë më gjunjë përpara të shenjtit sakrament e alterit të Zonjës së bekuar në Minervën , me sa lot e gjëmë e psherëtima të zemrës duke e lutur atë Zot të mëshërshëm e duke i thënë , se „ O Zoti im shum i ëmbli e i mëshërshmi , gazmendi i të hidhëruerve e shpresa e mëkatarëve e ndihma e forca e gjithë atyne , që me shpresë mbështeten prej teje ;
ti , qi ende parë se janë baam , mir i di e j njef gjithë kafshëtë e aqë maa tepërë gjithë të kujtuometë e përmbrendshime e dëshiretë e mendsë e të zemërësë sanë , – të lus , qi , nd ashtë këjo vepërë për ndoonjë ndimë oo fruj-të mirë të shpiirtit , temptë e t atii populli , ndoonëse u i paadenjë , mos e harro e mos e shtie poçtë këtë fëdigënë teme ;	ti , që ende parë se janë bërë , mirë i di e i njeh gjithë gjërat e aq më tepër gjithë të kujtuarit e përmbrendshëm e dëshirat e mendjes e të zemrës sonë , – të lus , që , në është kjo vepër për ndonjë ndihmë o frytë të mirë të shpirtit , temptë e të atij populli , ndonëse unë i padenjë , mos e harro e mos e shtjer poshtë këtë mundimin tim ;
ashtu as mos e venë roe aqë ndjerë nd anët të mangutë e të paadenjëtë tem , po të madhenë mëshërierrë tande , e m ep aqë hiir e gracie , qi ndo t a mbaronj për ndimë-të atii populli , si e kam nisunë , ndo të lirë ndë meent e zemërë-teme me shkuom e me e lanë “ .	ashtu as mos e vër re aq deri në anët të mangët e të padenjët tim , po të madhen mëshirë tënde , e më jep aq hir e gracie , që ndo ta mbaroj për ndihmë të atij populli , si e kam nisur , ndo të lirë në mend e zemrën time për të shkuar e për ta lënë “ .
Të ciatë fjalë me aqë t idhunë e mallënjim tue i thanë ndë vetëhe , saa maa i zoti me mbaajtunë lotë s jeshë , veçëse mbulova faqenë , mos banem me ndoonjë arrësye skandulliximi i shumë tierëve .	Të cilat fjalë me aq të hidhur e mallëngjim duke i thënë në vete , sa më i zoti të mbaja lotët s'isha , veçse mbulova faqen , mos bëhem me ndonjë arsye skandalizimi i shumë të tjerëve .
E kshtu ndeevonë , kuur maa tue kujtuom me e mplasunë gjithë kafshënë e me shkuom – Zotyynë m a di e m ashtë për dëshmi , zotënii e shokë e vëllazënë ! , se nd aqë veçë kuur tee gjejshë mb anë të djathë një kshiill , qi më tha , se : „ Saa maa të fëdigeesh , aqë maa mirë kie me j  mbaruom gjithë kafshëtë “ .	E kështu më vonë , kur më duke kujtuar për ta plasur gjithë gjënë e të shkoja – Zoti ynë ma di e më është për dëshmi , zotërinj e shokë e vëllezër ! , se në aq veç kur ta gjesh më anë të djathtë një këshillë , që më tha , se : „ sa më të mundohesh , aq më mirë kanë për t'u mbaruar gjithë gjërat “ .
Të ciinë zaa oo kshiill aqë bukur nçelë qi e gjejshë e e ndëgjova , saa mb atë ças përnjëherë tue mpshiim lotë e tue dhanë lavd Tinëzot e Zotnjësë beekuome , u mbushçë gjithë plot me gazimend e me ngushëllim , e me shpëresë me j mbaruom gjithë kafshëtë .	Të cilin zë o këshillë aq bukur çelë që e gjeta e e kuptova , sa më atë ças përnjëherë duke fshirë lotët e duke i dhënë lavd Tinëzot e Zonjës së bekuar , u mbusha gjithë plot me gazmend e me ngushëllim , e me shpresë për t'i mbaruar gjithë gjërat .
E kshtu mb atë ças vojta , zuna fiill përserii ;	E kështu më atë çast vajta , zura fill përsëri ;
saa maa për të çpejtë qi munda , i shkrova e j ndëreqa maa mirë gjithtë kafshëtë , qi keshë shkruom e baam gaatii maa mpari .	sa më për të shpejtë që munda , i shkrova e i ndëreqa më mirë gjithë gjërat , që kisha shkruar e bërë gati më parë .
Ende maa tepërë nçtova rubrikëtë e Rituallit Romësë me gjithë saa tjera urdhënime kaa ndë vetëhe , me shpëresë ende ato bashkë me tjerat me j shtampuom , sikundrëse thashë përsipëri .	Edhe më tepër shtova rubrikat e Ritualit të Romës me gjithë sa të tjera urdhërime ka në vete , me shpresë edhe ato bashkë me të tjerat për t'i shtypur , sikundërse thashë përsipër .
Të ciatë , posikundrëse ashtu ish vullëndetja e Tinëzot , posaa përnjëherë tue i mbaruom , veçë kuur tee e mbërrini i ndëjyemi dom Simonë Ngjeqi prej Leshe me lypunë upeshkëpiinë e Zadrimësë .	Të cilat , posikundërse ashtu ish vullneti e Tinëzot , po sa përnjëherë duke i mbaruar , veç kur tek e mbërriti i ndjeri dom Simon Ngjeqi prej Leshi për të lypur ipeshkëvin e Zadrimës .
Të ciinë këtu mirë tue e njofunë n’jerii të diijtëshim e plot me letërë , mb atë ças j a dhanë e s j a menguonë ;	Të cilin këtu mirë duke e njohur njeri të dijshëm e plot me letër , më atë çast ia dhanë e s'ia mënguan ;
e jo veçëse upeshkëpiinë , qi lypi , po ashtu ende gjithë këto letëra e të shkruometë e mii , me të ciat i keshë maa shurdhuom e mërzitunë , atii j a dhanë e j a rekumenduonë me j paam e bukur me j provuom , se pa si jesënë oo për qish ndimë kanë me qenë t atii populli .	e jo veçse ipeshkëvin , që lypi , po ashtu edhe gjithë këto letra e të shkruarit e mi , me të cilat i kisha shumë shurdhuar e mërzitur , atij ia dhanë e ia rekomanduan për t'i parë e bukur për t'i provuar , se pasi mbeten o për ç'ndihmë kanë për të qenë të atij populli .
I cilli kaa pak për gjithë ditë bukur tue i vuum roe fjalë për fjalë e puntë për puntë , përnjëherë tue i mbaruom , mbet e tha , se : A domino factum est istud , & est mirabile in oculis nostris .	I cili ka pak për gjithë ditë bukur duke i vënë re fjalë për fjalë e pikë për pikë , përnjëherë duke i mbaruar , mbeti e tha , se : A domino factum est istud , & est mirabile in oculis nostris .
Ani mb atë ças muor pendënë e kalamaarrë , e jo veçëse me dorë të vet shkroj e j bani këtë dëshminjenii , qi aa vuum përsipëri , po ashtu ende vetë hini ke mjeshtri i Pëllasit e mbë saa vise të tjera , ke qe zyra , tue i lutunë , qi për gjith arrësye të shtampohetë , se kaa me qenë për të madhe ndimë e të nçelët syytë shumëve .	Ani më atë çast mori pendën e kallamarin , e jo veçse me dorë të vet shkroi e i bëri këtë dëshmi , që është vënë përsipër , po ashtu edhe vetë hyri te mjeshtri i Pallatit e mbë sa vise të tjera , ku qe puna , duke i lutur , që për gjithë arsye të shtypet , se ka për të qenë për të madhe ndihmë e të çelët syytë shumëve .
E kshtu kuur tue qenë maa kafshë gaatii mbë të zanët fiill , gjukata veçë kuur tee goditi , sikundrëse mortja e këtii t ndëjyemit upeshkëpit Simon , ashtu ende e papësë Paalit V. ;	E kështu kur duke qenë çdo gjë gati më të zënët fill , gjykata veç kur të goditi , sikundërse mortja e këtij të ndjerit ipeshkëv Simon , ashtu edhe e papës Paalit V. ;
e ndjer u baa tjetëri , qi a tashti : shinti atë papa Gregorio XV. , u desh me shkuom disa mot .	e deri u bë tjetri , që është tashti : shenjti atë papa Gregorio XV. , u desh të shkonin disa mote .
T ciillt Zotyynë i ngjatë jetënë e j a pagoftë me shumë të mirë të kesaaj jete ende të tjetërësë , përse me të parët fjalë mbasi e ndëgjoj bukur kafshënë , maa s desh me e vonuom as me e përciellë ditë mbë ditë , po mb atë ças urdhënoj , të zihetë fiill , saa maa çpejt të mbarohetë .	Të cilit Zoti ynë i zgjattë jetën e ia pagoftë me shumë të mirë të kësaj jete edhe të tjetrës , përse me të parën fjalë mbasi e kuptoi bukur gjënë , më s'desh ta vononin as për ta përcjellë ditë më ditë , po më atë çast urdhëroi , të zihet fill , sa më shpejt të mbarohet .
E mbasandaj u këtë tue shtampuom , veçë kuur tee me një fjalë të zotëniisë ndritshim Marino Bicit , argjupeshkëpit Tivarit , muorrë e më ngarkuonë ende barrënë e kësaaj upeshkëpiisë Zadrimësë , qi u askurraj ndë mend s e keshë pasunë .	E mbasandaj unë këtë duke shtypur , veç kur tek me një fjalë të zotnisë së ndritshëm Marino Bicit , argjipeshkëvit të Tivarit , morën e më ngarkuan edhe barrën e kësaj ipeshkëvisë së Zadrimësë , që unë askurrë në mend s'e kisha pasur .
Praashtu desha me u thanë , të mii zot e shokë e vëllazënë ! , se u ndjerë mp tashti , aqë saa munda , s mengova ndë këtë vepërë , e këndyy tutje ndoonësë e pakë e përpara Tinëzot e përpara shekullit e rekumendonj e e porësit  ndë dorë-të zotëniisë saaj posi miqet t dashunë për ndeer , kafshënë maa të dashunënë , qi të keshë  përmbii dheet , ashtu qi , ndoonëse me pak fëdigë mbasi t a kini bukurë ndëgjuom , t iini të zotë jo veçëse me e porësitunë e me e rrekomenduom , mbë gjithë kishët e viset tuoj të shërbenetë , e të jeetë ligja mbë vent , si ashtë urdhënuom , – po ashtu ende me saa të denja e të dërejta arrësenje me e ndimuom e me j pruojtunë fjalëshit e shigjetëshit së ndoonjii , qi të duoj ashtu me ngatërruom e me folë gjaakafshë ende kundrë së dërejtësë .	Pra ashtu desha t'u them , të mi zot e shokë e vëllëzër ! , se unë deri më tashti , aq sa munda , s mëngova në këtë vepër , e këndej tutje ndonësë e pakë e përpara Tinëzot e përpara botës e rekomandoj e e porosit në dorë të zotnisë së tij posi miqve të dashur për nder , gjënë më të dashur , që të kisha përmbi dhe , ashtu që , ndonëse me pak mundim mbasi ta keni bukur kuptuar , të jeni të zotë jo veçse ta porositni e ta rekomendoni , më gjithë kishat e viset tuaja të shërbehet , e të jetë ligji më vend , si është urdhëruar , – po ashtu edhe me sa të denja e të drejta arsye për ta ndihmuar e për ta pruajtur prej fjalëve e shigjetave të ndonjë , që të dojë ashtu të ngatërrojë e të flasë gjëkafshë edhe kundër së drejtës .
Mirë tue diijtunë posi përsipëri , se anëmiku aj plaku e dashëkeqi i gjithë t miravet , qi ndjerë mp tashti i shtiu gjith aqë kundrështii e të peenguome , të mos banetë , tashti kuur u baa e u mbaruo ende kundra vullëndetsë tii , as këndyy tutje , për qish të mundnjë , s kaa me menguom me j shtiim kundrë e me j vdierrë frujtinë , qi të kish me baam , ndë mos me tjetërë aj ndoonee me invidiet e resë-të disave , qi vetë tue mundunë ende maa mirë s kanë dashm me u fëdigunë , e n doret së tjerëve s kanë me mundunë me e paam .	Mirë duke ditur posi përsipër , se armiku ai plaku e dashakeqi i gjithë të mirave , që deri më tashti i shtiu gjithaq kundrështi e të penguara , të mos bëhet , tashti kur u bë e u mbarua edhe kundër vullnetit të tij , as këndej tutje , për ç'të mundë , s'ka për të mënguar për t'i shtirë kundër e për t'i vdjerrë frytin , që të kish për të bërë , në mos me tjetër aj ndonjë me zilitë e resë të disave , që vetë duke mundën edhe më mirë s'kanë dashur të mundohen , e prej dorës së të tjerëve s'do të mundin ta shohin .
Të ciitë ende ata i lus për pjesë të Tinëzot , të mos e veenë roe aqë ndjerë nd anët të mangutë tem ndë këtë vepërë , qi maa mirë s qesh i zoti me e ndërequnë , – po të randëtë e damit , qi u baa ende po banetë , e të vdjerrëtë e gjith aqii shpiirte , qi u vduorrë ende po vdaarenë veçëse aqii ncë mituni e ncë paadiijtuni , e ligjnë e Tinëzot e të shintesë kishë , e vepëratë e t kërshtenëvet , qi maa ndë të shumët pjesë ncish u vduorë ende po vdaarenë ;	Të cilët edhe ata i lus për pjesë të Tinëzot , të mos e vënë re aq deri në anët të mangut tem në këtë vepër , që më mirë s'qesh i zoti ta ndreqja , – po të rëndët e dëmit , që u bë edhe po bëhet , e të vdjerrët e gjith aq shpirtrave , që u vdorën edhe po vdaren veçse aq së mituri e së paadituri , e ligjin e Tinëzot e të së shenjtës kishë , e veprat e të krishterëve , që ma në të shumët pjesë sish u vdorën edhe po vdaren ;
e ndeevonë me dorët mbë zemërë të venë roe pakëzë , se motnë e të riitë e vet ndjerë mp sod ndë se e kanë spenxuom ende po e spenxonjënë , mirë tue mundunë ashtu gjaakafshë me ndimuom ende saa të tjerë , qi mb atë arrësye duonë e dëshëronjënë të mjerëtë me u ndimuom e paa ndimë kënco letërash mbë gjuhu-të tyne s janë të zotë me u ndimuom as me mbushunë oficienë e vet e shërbëtyrënë e kishësë shinte , sikundrëse do ligja , e janë detuor e mbaajtunë ;	e pastaj me dorë më zemër të vënë re pakëz , se motin e të ritë e vet deri më sot në se e kanë shpenzuar edhe po e shpenzojnë , mirë duke mundur ashtu gjëkafshë për të ndihmuar edhe sa të tjerë , që më atë arsye duan e dëshirojnë të mjerët të ndimohen e pa ndimë këso letrash më gjuhë të tyre s'janë të zotë të ndimohen as për të mbushur detyrën e vet e shërbesën e kishës së shenjtë, sikundërse do ligji , e janë detorës e mbajtur ;
kahaa munë thomi , se erdhnë ende gjithë dametë e të meenguometë e tjera të gjuhusë sanë ndjerë mp sod , e sod e këtë ditë mbë saa vise maa tepërë me dhuunë se askuurraaj .	nga mund të themi , se erdhën edhe gjithë dëmet e të munguarat e tjera të gjuhës sonë deri më sot , e sot e këtë ditë më sa vise më tepër me dhunë se askurrë .
Të ciatë kafshë tue mundunë ndo me një arrësye ndo me një tjetër me u ndimuom , s dii , a ish arrësye aqë ndjerë nd anët me u shtiim mbas shpine e sikuur ndë të harruom , përse , kuur kshtu tue vuum roe gjithëkush vetë ndë vetëhe , e ndë konshencie-të vet , thom , se pak kaa me mbaajtunë muo fajëtuor , qi maa tej s qesh i zoti me e mbërriim , – po maa tepërë vetëvetëhenë , qi tue mundunë ende maa mirë , s kaa dashunë me u fëdigunë .	Të cilat kafshë gjëra mundur ndo me një arsye ndo me një tjetër për t'u ndihmuar , s di , a ish arsye aq deri në anët të shtihej mbas shpine e sikur në të harruar , përse , kur kështu duke vënë re gjithkush vetë në vete , e në ndërgjegje të vet , them , se pak ka për të mbajtur mua fajtor , që më tej s'qeshë i zoti ta mbërrij , – po më tepër vetveten , që duke mundur edhe më mirë , s'ka dashur të mundohej.
E cia kafshë ndoonëse e pakë të kish qenë baam ndë kohot , s më ndjetë , se ish baam gjith aqi i madh dam e të vdjerrë mbë saa vise , saa askuurraj kandi s i dihetë .	E cila gjë ndonëse e pakë të kish qenë bërë në kohë , s'më ndiet , se ish bërë gjithë aq i madh dëm e të vdjerrë më sa vise , sa askurrkund s'i dihet .
E tashti ende sod e këtë ditë kuur të duoj ndoonjë me u fëdigunë me nkthyem katekisminë ndo jetënë e shintënet , – ndë mos gjithë , ndonee ato , qi di , se janë për ndimë të atii dheu , – ndo Sermones discipuli oo qishdo ashtu tjetër copë letërë mb atë arrësye të frujtuoshime , saa e madhe ndimë e dritë e gazimend e ngushëlëm kish me qenë j atii populli , qii maa të shumënë u vduorrë ende po vdaarenë të mjerëtë veçëse aqii ncë mituni e ncë paadiijtuni , tue mos qenë kush t i ndimon e të pron për ta me gjithë zemërë , sikundrëse e kanë gjithë rrethi i shekullit ;	E tashti edhe sot e këtë ditë kur të donte ndonjë të mundohej për ta kthyer katekizmin ndo jetën e shenjtëve , – në mos gjithë , ndonjë nga ato , që di , se janë për ndihmë të atij dheu , – ndo Sermones discipuli o qyshdo ashtu tjetër copë letër më atë arsye të frytshme , sa e madhe ndihmë e dritë e gazmend e ngushëllim kish për të qenë i atij populli , që më të shumën u vdorën edhe po vdirren të mjerëtë veçse aq së mituri e së padituri , duke mos qenë kush t'i ndimojë e të pruajë për ta me gjithë zemër , sikundërse  e kanë gjithë rrethi i botës ;
po qish banetë , thuose ma e shuma pjesë banetë veçëse sikuur për zakoni e për faqe të shekullit , nd ish asndoonjë kafshë me të madh zeell e dëshiir , sikundrëse do ligja e janë detuor e mbaajtunë .	po qysh bëhet , thuase më e shuma pjesë bëhet veçse sikur për zakoni e për faqe të botës, në ish asndonjë gjë me të madh zell e dëshirë , sikundërse  do ligji e janë detorës e mbajtur .
E aqë maa tepërë do letërorë e të mëdhenj dies , qi letërënë e diinë e të pakë frujt me ta kallëzonjënë ;	E aq më tepër do letrarë e të mëdhenj dies , që shkrimin e dinë e të pakë fryt me të kallëzojnë ;
e se , ndë dashçinë ashtu gjaakafshë me baam oo me kallëzuom , e ata heret së keqet së tynet s e banjënë ndoonee mbë gjuhu-të vet , ke diinë , se ashtë maa tepërë zyra e nevoja , po mbë të tjera gjuhu , ke asndoonjë nevojë s ashtë , – mb arrësye të ndoonjii , qi të baan ujë e të shtiij ndë deet , oo të ndoonjii tjetëri , qi të shpiijte vobëziinë e vet me e falë ndë kurtë-t begatëvet , ke zyrë e nevojë s ashtë , as për ndeer s i quhetë , e vëllazënitë e gjëniinë e vet i lee me u vdierrë n zie e unie e n gjithë duorshit së nevojëvet .	e se , në daçin ashtu gjëkafshë të bëjnë o të kallëzojnë , e ata heret së keqe të tyre s'e bëjnë ndonjë më gjuhë të vet , ku dinë , se është më tepër detyra e nevoja , po më të tjera gjuhë , ku asndonjë nevojë s'është , – më arsye të ndoonjë , që të bën ujë e të shtie ndë det , o të ndonjë tjetri , që të shpinte varfërinë e vet ta falë në oborr të të begatëve , ku detyrë e nevojë s'është , as për nder s'i quhet , e vëllezërt e gjininë e vet i lë të vdirren në zi e uri e në gjithë duorshit të nevojave .
Praashtu , o zotënii e shokë e vëllazënë ! , tashti ende saa ashtë moti e koha , eeni , nqonemi e nçelnjëmë syytë pakëzë vetë ndë vetëhe , mos na gjeenjë mortja me syyt mbërshelë e tue fjetunë ndë gjumë-të t paakujdesit me vdierrë regjëniinë e qiellet , përse non intrabit in regnum cælorum , qui dicit mihi Domine , Domine &c. – vetë shinteja goja e Krishtit tue thanë , se : asndoonjë s kaa me hiim ndë regjënii- të qiellet ancish , qi veçëse më thërresënë „ Zot , Zot ! “ , paa ndoonjë tjetër vepërë të mirë ;	Pra ashtu , o zotërinj e shokë e vëllëzër ! , tashti edhe sa është moti e koha , ejani , zgjohemi e çelim sytë pakëz vetë në vete , mos na gjejë mortja me sytë mbyllur e duke fjetur në gjumë të të pakujdesit për vdjerrë mbretërinë e qiellit , përse non intrabit in regnum cælorum , qui dicit mihi Domine , Domine &c. – vetë eshenjta goja e Krishtit duke thënë , se : asndonjë s'o të hyjë në mbretëri të qiellit asish , që veçse më thërrasin  „ Zot , Zot ! “ , pa ndonjë tjetër vepër të mirë ;
po kush të banjë vullëndetnë e Ati-tim , qi ashtë mbë qiellt , ipse intrabit in regnum cælorum : aj kaa me hiim ndë regjënii-të qiellet ;	po kush të bëjë vullnetin e Atit tim , që është më qiell , ipse intrabit in regnum cælorum : ai ka për të hyrë në mbretëri të qiellit ;
e përsërii : qui fecerit & docuerit , is magnus vocabitur in regno celorum , sikuur të duoj me thanë , se : kush e mpsoj e e predikoj e ndeevonë ende me vepëra e kallëzoj , ipse magnus vocabitur in regno cælorum : aj i madh e j lum kaa me u quojtunë ndë regjënii-të qiellet .	e përsëri : qui fecerit & docuerit , is magnus vocabitur in regno celorum , sikur të duonte të thoshte , se : kush e mësoi e e predikoi e pastaj edhe me vepra e kallëzoi , ipse magnus vocabitur in regno cælorum : ai i madh e i lum do të quhet në mbretëri të qiellit .
Të ciinë lavd e regjënii për të madhet mëshërier të vet gjithë ncë bashku nee dhashtë Ati e Biri e Shpiirti shint , ke të lëvdojmë e të përlëvdojmë shintinë emënitë e tii për gjithë jetë-të jetësë .	Të cilën lavd e mbretëri për të madhe mëshirë të vet gjithë së bashku nee dhashtë Ati e Biri e Shpirti i shenjtë , ku të lëvdojmë e të përlëvdojmë të shenjtin emër të tij për gjithë jetë të jetës .
Amen .	Amen .
Ashtu qoftë .	Ashtu qoftë .
Numëri maa udob për të gjetunë gjithë saa kapituj e kafshë n krye janë përmbrenda kësaaj letëre .	Numri më i dobishëm për të gjetur gjithë sa kapituj e gjëra në krye janë përbrenda këtij libri.
Të zanëtë fiill mbë numuritë .	Të zënët fiill më numrin .
Të vuumitë roe të konfesorëvet , qi rrëfyenjënë .	Të vënët re të rrëfyesve, që rrëfejnë .
Kuur kush vjen me u rrëfyem .	Kur kush vjen të rrëfehet .
Ncë 15. arrësenjeshit , qi vihenë roe nde këtë kafshë .	Së 15. arrësenjeshit , që vihen re në këtë gjë.
Ncë 10 urdhënimeshit së ligjsë Tinëzot .	së 10 urdhërimeve të ligjit të Tinëzot .
Pjeset së dyyjtë ndë urdhëni-të parë .	Pjesët së dytë ndë urdhëni të parë .
Beeshit së rreeshimesh .	Beeshit së rreeshimesh .
Kushtimeshit së baamesh .	Kushtimesh së bërash .
Urdhënit së tretë .	Urdhrit të tretë .
Kreshmëshit e vëngjillëshit .	Kreshmëve e ungjillëve .
Urdhënit së katërtë .	Urdhrit të katërt .
Të pyetunitë e prindet për fëmii-të vet .	Të pyeturit e prindërve për fëmijë të vet .
Për të martuomit , si do ligja .	Për të martuarit , si do ligji .
Urdhënit së pestë mbë .	Urdhrit të pestë më .
Mixyrëshit së Shpiirtit .	Mizorisë së Shpirtit .
Urdhënit së gjashtë mbë .	Urdhrit të gjashtë më .
Gjithë duorshit së kurvëniivet . .	Gjithë llojet e kurvërive . .
Ende mbë saa tjera arrësenje . .	Edhe më sa të tjera arrësenje . .
Dëshireshit e ncë kujtuomeshit .	Dëshirave e të kujtuarve .
Burri me gruo-të vet .	Burri me grua të vet .
Urdhënit së shtatë mbë .	Urdhrit të shtatë më .
Kamatëshit e tregëtiishit së rreeshime .	Kamatave e tregëtive të rrejshme .
Lavdit së mbrazëtë .	Lavdit të zbrazët .
Mpkateshit së mbuluomesh .	Mëkateve të mbuluara .
Madhështiet së graavet .	Madhështisë së grave .
Zmirit e rese ncë keqe .	Smirës e resë së keqe .
Ncë nkthyemit së ndeersë e ncë zanit mirë .	Të kthyerit të nderit e të zërit të mirë .
Përteset e ncë paakujdesit .	Përtesat e së pakujdesit .
Lëmoshënashit e vepërashit së mëshëriersë korpit .	Lëmoshërave e veprave së mëshirës së trupit .
Vepërashit së mëshëriersë shpiirtit .	Veprave së mëshirës së shpirtit .
Sakramenteshit së kishësë .	Sakramenteve të kishës .
Ncë krezmuomit së fëmiisë .	Të krezmuarit e fëmijës .
Ncë rrëfyemit e peendeset .	të rrëfyerit e pendesat .
Ncë kunguomit .	Të kunguarit .
Upeshkëpinjet e tjerë prelate .	Ipeshkëvet e të tjerë prelatë .
Priftënet e gjakonet .	Priftërinjve e dhjakët .
Ncë thanit së meshëvet .	Të thënit të meshëve .
T paret e zotëniivet .	Të parët e zotërinjve .
Gjukatëset .	Gjykatësve .
Mjeeqet e atyne , qi mëngjisnjënë .	Mjekëve e atyre , që mëngjisin .
Disave , qi majshtronjënë me do barëna .	Disave , që mashtrojnë me do barna .